QUESTION	INTENT
윈터솔져 나오는 2018년 개봉한 영화 제목이 뭐지?	findMovie
타노스 나오는 영화 알려줘	findMovie
어벤져스 3편 이름 알려줘	findMovie
어벤져스 최신작 알려줘	findMovie
어벤져스 최근작품이 뭐지?	findMovie
루소형제 감독의 최근작품이 뭐지?	findMovie
MCU영화 알려줘	findMovie
많은 히어로들이 나오는 영화 알려줘	findMovie
초호화캐스팅의 헐리웃 영화 알려줘	findMovie
어벤져스2 속편 알려줘	findMovie
어벤져스 속편 알려줘	findMovie
토르라그나로크 다음에 볼만한 영화 알려줘	recommend
블랙팬서 다음에 볼 영화 알려줘	recommend
토르3편 다음에 볼 영화 알려줘	recommend
라그나로크 다음에 볼  영화 알려줘	recommend
번역논란된 히어로무비 알려줘	findMovie
박지훈번역가가 번역한 영화 알려줘	findMovie
닥터스트레인지 나오는 최신영화 알려줘	findMovie
그루트 출연하는 히어로무비 알려줘	findMovie
토르 나오는 히어로무비 알려줘	findMovie
캡틴아메리카 나오는 마블영화 이름이 뭐지?	findMovie
톰 히들스턴 출연하는 2018년 개봉한영화 알려줘	findMovie
마크러팔러 출연하는 히어로무비 이름이 뭐지?	findMovie
엘리자베스 올슨 출연하는 마블영화 제목이뭐지?	findMovie
엘리자베스 올슨 나오는 히어로무비 제목이뭐지?	findMovie
앤서니 매키 나오는 히어로무비 제목이뭐지?	findMovie
크리스에반스 출연하는 2018년 개봉한영화 제목이뭐지?	findMovie
아이언맨 나오는 디즈니영화 이름이뭐야?	findMovie
워머신 나오는 히어로무비 제목이뭐지?	findMovie
크리스에반스 나오는 2018년 개봉한영화 이름이뭐야?	findMovie
로키 나오는 마블영화 이름이 뭐지?	findMovie
로키 나오는 2018년 개봉한영화 알려줘	findMovie
헐크 출연하는 만화책 원작의 영화 이름이 뭐지?	findMovie
스타로드 출연하는 만화책원작의 영화 이름이뭐야?	findMovie
비전 나오는 마블영화 이름이 뭐지?	findMovie
비전 나오는 히어로무비 이름이 뭐지?	findMovie
토르 출연하는 마블영화 이름이 뭐지?	findMovie
엘리자베스 올슨 출연하는 2018년 개봉한 영화 제목이뭐지?	findMovie
비전 나오는 2018년 개봉한영화 알려줘	findMovie
그루트 나오는 2018년 개봉영화 제목이뭐지?	findMovie
피터파커 나오는 2018년 개봉영화 알려줘	findMovie
비전 나오는 히어로무비 제목이 뭐지?	findMovie
토르 출연하는 만화책원작의 영화 이름이 뭐지?	findMovie
앤서니 매키 나오는 만화책원작의 영화 이름이 뭐지?	findMovie
스파이더맨 출연하는 디즈니영화 이름이 뭐지?	findMovie
마크러팔러 출연하는 디즈니영화 이름이 뭐지?	findMovie
아이언맨 나오는 2018년 개봉한영화 제목이뭐지?	findMovie
워머신 출연하는 히어로무비 알려줘	findMovie
엘리자베스 올슨 출연하는 마블영화 이름이 뭐지?	findMovie
토르 나오는 마블영화 이름이뭐야?	findMovie
로키 나오는 만화책원작의 영화 알려줘	findMovie
스파이더맨 출연하는 마블영화 이름이뭐야?	findMovie
크리스 헴스워스 나오는 디즈니영화 알려줘	findMovie
피터파커 나오는 만화책원작의 영화 이름이 뭐지?	findMovie
톰 히들스턴 나오는 디즈니영화 이름이뭐야?	findMovie
아이언맨 출연하는 만화책원작의 영화 알려줘	findMovie
톰 히들스턴 출연하는 디즈니영화 알려줘	findMovie
아이언맨 출연하는 마블영화 이름이 뭐지?	findMovie
엘리자베스 올슨 출연하는 만화책원작의 영화 제목이뭐지?	findMovie
스칼렛 요한슨 출연하는 만화책원작의 영화 알려줘	findMovie
로버트 다우니 주니어 나오는 마블영화 제목이뭐지?	findMovie
캡틴아메리카 나오는 디즈니영화 이름이뭐야?	findMovie
워머신 나오는 마블영화 알려줘	findMovie
워머신 나오는 디즈니영화 알려줘	findMovie
엘리자베스 올슨 출연하는 마블영화 알려줘	findMovie
톰 히들스턴 나오는 디즈니영화 이름이뭐야?	findMovie
스파이더맨 나오는 마블영화 이름이 뭐지?	findMovie
스칼렛 요한슨 출연하는 히어로무비 이름이뭐야?	findMovie
워머신 출연하는 디즈니영화 제목이뭐지?	findMovie
로버트 다우니 주니어 나오는 디즈니영화 이름이뭐야?	findMovie
워머신 출연하는 만화책원작의 영화 이름이뭐야?	findMovie
피터파커 나오는 마블영화 제목이뭐지?	findMovie
비전 출연하는 히어로무비 제목이뭐지?	findMovie
피터파커 출연하는 만화책원작의 영화 알려줘	findMovie
로버트 다우니 주니어 나오는 만화책원작의 영화 이름이 뭐지?	findMovie
피터파커 나오는 만화책원작의 영화 이름이뭐야?	findMovie
캡틴아메리카 나오는 2018년 개봉한영화 알려줘	findMovie
그루트 출연하는 마블영화 알려줘	findMovie
스파이더맨 나오는 디즈니영화 이름이뭐야?	findMovie
마크러팔러 출연하는 마블영화 이름이 뭐지?	findMovie
워머신 나오는 마블영화 제목이뭐지?	findMovie
헐크 출연하는 디즈니영화 이름이뭐야?	findMovie
스칼렛 요한슨 출연하는 2018년 개봉한영화 이름이 뭐지?	findMovie
크리스 헴스워스 출연하는 만화책원작의 영화 제목이뭐지?	findMovie
피터파커 출연하는 만화책원작의 영화 이름이뭐야?	findMovie
워머신 출연하는 히어로무비 알려줘	findMovie
헐크 출연하는 마블영화 이름이뭐야?	findMovie
로키 나오는 히어로무비 이름이뭐야?	findMovie
스파이더맨 나오는 만화책원작의 영화 이름이뭐야?	findMovie
크리스에반스 나오는 만화책원작의 영화 알려줘	findMovie
피터파커 나오는 2018년 개봉한영화 알려줘	findMovie
인피니티스톤 모으는 영화 알려줘	findMovie
아이언맨 나오는 최신영화 알려줘	findMovie
MCU 페이즈3 영화 알려줘	findMovie
 보기전 볼 영화 알려줘	findMovie
캡틴마블 보기전 볼 영화 알려줘	findMovie
아이언스파이더슈트 나오는 영화 알려줘	findMovie
에보니모 나오는 영화 알려줘	findMovie
크리스 헴스워스 등장하는 2018 영화	findMovie
캡틴아메리카 등장하는 영화	findMovie
헐크 출연하는 최신영화	findMovie
엘리자베스 올슨 나오는 최신영화	findMovie
헐크 출연하는 2018 영화	findMovie
토르 등장하는 2018 개봉작	findMovie
토르 출연하는 최신영화	findMovie
스파이더맨 나오는 2018 영화	findMovie
캡틴아메리카 등장하는 최신영화	findMovie
아이언맨 출연하는 2018 개봉작	findMovie
로키 등장하는 최신영화	findMovie
비전 나오는 2018 개봉작	findMovie
마크러팔러 나오는 2018 영화	findMovie
로버트 다우니 주니어 출연하는 2018 영화	findMovie
헐크 등장하는 2018 영화	findMovie
마크러팔러 등장하는 2018 개봉작	findMovie
워머신 등장하는 2018 개봉작	findMovie
스파이더맨 나오는 영화	findMovie
캡틴아메리카 등장하는 2018 영화	findMovie
윈터솔져 나오는 2018 영화	findMovie
그루트 출연하는 2018 개봉작	findMovie
헐크 등장하는 최신영화	findMovie
엘리자베스 올슨 나오는 2018 개봉작	findMovie
피터파커 등장하는 2018 영화	findMovie
헐크 등장하는 최신영화	findMovie
캡틴아메리카 출연하는 영화	findMovie
스타로드 출연하는 2018 개봉작	findMovie
스타로드 등장하는 영화	findMovie
마크러팔러 등장하는 2018 개봉작	findMovie
토르 등장하는 영화	findMovie
캡틴아메리카 나오는 2018 영화	findMovie
그루트 등장하는 2018 개봉작	findMovie
아이언맨 나오는 2018 영화	findMovie
톰 히들스턴 출연하는 최신영화	findMovie
헐크 나오는 2018 개봉작	findMovie
로키 나오는 최신영화	findMovie
워머신 출연하는 영화	findMovie
크리스에반스 등장하는 2018 개봉작	findMovie
스타로드 등장하는 최신영화	findMovie
헐크 등장하는 2018 개봉작	findMovie
로키 등장하는 영화	findMovie
캡틴아메리카 출연하는 영화	findMovie
앤서니 매키 등장하는 2018 개봉작	findMovie
톰 히들스턴 나오는 2018 영화	findMovie
크리스 헴스워스 출연하는 최신영화	findMovie
로키 나오는 2018 개봉작	findMovie
앤서니 매키 출연하는 최신영화	findMovie
톰 히들스턴 나오는 2018 영화	findMovie
그루트 등장하는 2018 영화	findMovie
톰 히들스턴 출연하는 영화	findMovie
헐크 출연하는 2018 영화	findMovie
워머신 출연하는 영화	findMovie
헐크 나오는 2018 개봉작	findMovie
윈터솔져 출연하는 2018 영화	findMovie
톰 히들스턴 출연하는 최신영화	findMovie
엘리자베스 올슨 출연하는 최신영화	findMovie
톰 히들스턴 나오는 2018 개봉작	findMovie
라라랜드 주인공 알려줘	findMovie
라라랜드 남자 주인공 알려줘	findMovie
라라랜드 여자 주인공 알려줘	findMovie
라라랜드 감독 이름 알려줘	findMovie
라라랜드 남자 주인공 이름 알려줘	findMovie
라라랜드 여자 주인공 이름 알려줘	findMovie
라이언 고슬링 나오는 영화 알려줘	findMovie
라이언 고슬링 주연인 영화 알려줘	findMovie
라이언 고슬링 영화 알려줘	findMovie
엠마 스톤 나오는 영화 알려줘	findMovie
엠마 스톤 등장하는 영화 알려줘	findMovie
세바스찬 나오는 영화 알려줘	findMovie
미아 나오는 영화 알려줘	findMovie
세바스찬 와일더 나오는 영화 알려줘	findMovie
미아 돌런 나오는 영화 알려줘	findMovie
데이미언 셔젤 영화 알려줘	findMovie
위플래시 감독 영화 알려줘	findMovie
J.K.시몬스 나오는 영화 알려줘	findMovie
저스틴 허위츠가 작곡가인 영화 알려줘	findMovie
라라랜드 OST 작곡가 이름 알려줘	findPerson
라라랜드 개봉일 알려줘	getOpenDate
라라랜드 개봉년도 알려줘	getOpenDate
뮤지컬 영화 알려줘	findMovie
멜로 영화 알려줘	findMovie
로맨스 영화 알려줘	findMovie
재즈 영화 알려줘	findMovie
사랑 영화 알려줘	findMovie
음악 영화 알려줘	findMovie
뮤직 로맨스 영화 알려줘	findMovie
드라마 영화 알려줘	findMovie
국내 12세 영화 알려줘	findMovie
PG-13 영화 알려줘	findMovie
재개봉한 영화 알려줘	findMovie
2016년 개봉 영화 알려줘	findMovie
2017년 재개봉 영화 알려줘	findMovie
2016년 개봉한 외국 영화 알려줘	findMovie
외국 뮤지컬 영화 알려줘	findMovie
외국 로맨스 영화 알려줘	findMovie
외국 재즈 영화 알려줘	findMovie
외국 사랑 영화 알려줘	findMovie
외국 음악 영화 알려줘	findMovie
외국 뮤직 로맨스 영화 알려줘	findMovie
아름다운 영화 알려줘	recommend
감동적인 영화 알려줘	recommend
인생 영화 알려줘	recommend
꿈꾸고 싶게하는 영화 알려줘	recommend
주인공들이 꿈을 꾸는 영화 알려줘	findMovie
꿈을 이루는 영화 알려줘	findMovie
영상미 좋은 영화 알려줘	recommend
환상적인 영화 알려줘	recommend
어른들을 위한 동화같은 영화 알려줘	recommend
연인들이 볼만한 영화 알려줘	recommend
첫 사랑이 생각나는 영화 알려줘	recommend
음악이 좋은 영화 알려줘	recommend
엔딩이 좋은 영화 알려줘	recommend
결말이 좋은 영화 알려줘	recommend
결말이 좋은 영화 알려줘	recommend
여운이 남는 영화 알려줘	recommend
감수성이 충만해지는 영화 알려줘	recommend
낭만적인 영화 알려줘	recommend
눈물 나는 영화 알려줘	recommend
울게 하는 영화 알려줘	recommend
아름다운 음악 영화 알려줘	recommend
명작 영화 알려줘	recommend
탄성 나오는 영화 알려줘	recommend
아련한 영화 알려줘	recommend
춤과 노래가 나오는 영화 알려줘	findMovie
황홀한 영화 알려줘	recommend
결말이 슬픈 영화 알려줘	recommend
오디션 보는 영화 알려줘	recommend
OST가 좋은 영화 알려줘	recommend
밴드가 나오는 영화 알려줘	findMovie
결말이 반전인 영화 알려줘	recommend
가슴 아픈 영화 알려줘	recommend
새드 엔딩인 영화 알려줘	recommend
결말이 별로인 영화 알려줘	recommend
피아노 영화 알려줘	findMovie
따뜻한 영화 알려줘	recommend
연출이 좋은 영화 알려줘	recommend
LA가 나오는 영화 알려줘	findMovie
로스엔제렐스가 나오는 영화	findMovie
매력적인 영화 알려줘	recommend
눈과 귀가 즐거운 영화 알려줘	recommend
크리스마스때 보기 좋은 영화 알려줘	recommend
기념일에 보기 좋은 영화 알려줘	recommend
달콤한 영화 알려줘	recommend
탭댄스 추는 영화 알려줘	findMovie
결말이 현실적인 영화 알려줘	recommend
현실적인 영화 알려줘	recommend
오프닝이 멋진 영화 알려줘	recommend
커플이 헤어지는 영화 알려줘	findMovie
커플이 깨지는 영화 알려줘	findMovie
짝사랑을 생각나게 하는 영화 알려줘	recommend
옛날 남자친구 생각나게 하는 영화 알려줘	recommend
옛날 여자친구 생각나게 하는 영화 알려줘	recommend
색감이 예쁜 영화 알려줘	recommend
색채가 예쁜 영화 알려줘	recommend
야경이 예쁜 영화 알려줘	recommend
커플이 보기 좋은 영화 알려줘	recommend
배경이 예쁜 영화 알려줘	recommend
심장이 떨리는 영화 알려줘	recommend
심장이 간질거리는 영화 알려줘	recommend
상을 받은 영화 알려줘	findMovie
골든글로브 받은 영화 알려줘	findMovie
호불호가 갈리는 영화 알려줘	recommend
상큼한 영화 알려줘	recommend
청춘 영화 알려줘	findMovie
열정이 넘치는 영화 알려줘	recommend
씁쓸한 내용이 나오는 영화 알려줘	recommend
애잔한 영화 알려줘	recommend
마음이 먹먹한 영화 알려줘	recommend
노래 부르는 영화 알려줘	findMovie
최고의 영화 알려줘	recommend
오마주를 담은 영화 알려줘	findMovie
사극 영화 뭐가 있어?	findMovie
사극 영화 뭐가 있지?	findMovie
전쟁 영화로 어떤게 있지?	findMovie
전쟁 영화로 어떤게 있어?	findMovie
고구려 시대 영화는?	findMovie
고구려 시대 영화 보여줘	findMovie
요동 지역 나오는 영화는?	findMovie
요동 지역 나오는 영화는 뭐있냐?	findMovie
조인성 나오는 영화	findMovie
조인성 나오는 영화가 뭐야?	findMovie
양만춘 장수가 나오는 영화는?	findMovie
양만춘 장수가 나오는 영화는 뭐가있어?	findMovie
대규모 전쟁신 있는 영화는 뭐가 있지?	findMovie
대규모 전쟁신 있는 영화는 뭐가 있어요?	findMovie
9월에 개봉한 영화는?	findMovie
9월에 개봉한 영화는 뭐가있지?	findMovie
올해 가을에 개봉한 영화	findMovie
2018 가을에 개봉한 영화	findMovie
500만 관객 이상인 영화는?	findMovie
500만 관객 이상인 영화	findMovie
김광식 감독 영화	findMovie
김광식 감독 영화 보여줘	findMovie
안시성 영화 감독은?	findMovie
안시성 영화 감독 누구야?	findPerson
액션영화 소개	findMovie
액션영화 보여줘	findMovie
네이버영화평점 8점 이상인 영화는?	findMovie
네이버영화평점 8점 이상인 영화?	findMovie
역사물 영화 뭐있어?	findMovie
역사물 영화 보여줘	findMovie
우리나라 장수 나오는 영화	findMovie
우리나라 장수 나오는 영화는?	findMovie
박성욱이 연기한 영화는?	findMovie
박성욱이 연기한 영화 뭐지?	findMovie
이세민이 나오는 영화	findMovie
이세민이 나오는 영화 뭐있어?	findMovie
당과 고구려 전투 관련 영화는 뭐가 있습니까?	findMovie
당과 고구려 전투 영화는?	findMovie
영화에 설현이 나오는거 다 알려줘	findMovie
영화에 설현이 주연인 영화	findMovie
지루하지 않은 영화 소개해줘.	recommend
지루하지 않은 영화 소개해.	recommend
안시성에 출연한 배우는?	findPerson
안시성에 출연한 배우 누구있어?	findPerson
감동적인 영화	recommend
감동적인 영화 보여줘	recommend
안시성에서 설현이 사랑하는 사람으로 나오는 배우는?	findPerson
안시성에서 설현이 사랑하는 사람으로 나오는 배우는 누구?	findPerson
배우 엄태구 나오는 영화	findMovie
배우 엄태구 나오는 영화 뭐지?	findMovie
배성우 나오는 영화	findMovie
배우 배성우 출연 영화	findMovie
영화 안시성에서 이세민이 마지막으로 쓰는 방법은?	findPlot
영화 안시성에서 이세민이 전쟁 패배후 고안한 방법은?	findPlot
재밌는영화	recommend
재밌는영화 보여줘	recommend
러닝타임 130분 이상 영화는 뭡니까?	findMovie
상영시간 130분 이상 영화는 뭡니까?	findMovie
12세 관람가 영화 출력	findMovie
안시성이 12세 관람가야?	isTrue
안시성에서 조인성이 한 역할은?	getCast
안시성에서 조인성은 뭐했어?	getCast
안시성에서 나오는 인물들은?	getCast
안시성에서 나오는 인물들을 알고싶다	getCast
영화 안시성 배우	findPerson
활이 나오는 영화 보고싶다	findMovie
활이 나오는 영화 보여줘	findMovie
전투씬 멋있는 영화가 뭐냐	recommend
전투씬 멋있는 영화 보여줘	recommend
전쟁씬 최고인 영화	recommend
전쟁씬 최고인 영화는?	recommend
박진감있는 영화 보여줘	recommend
박진감있는 영화 뭐있어?	recommend
교육적인 영화는?	recommend
역사를 배울 수 있는 영화?	recommend
중학생도 볼 수 있는 영화는?	findMovie
중학생 관람가 영화는?	findMovie
당나라 군대가 안시성 성문을 뚫고 들어왔는데도 전멸당한 이유는?	findPlot
안시성 내 고구려 군대 수는?	findPlot
안시성 영화에서 당나라 군사 수는?	findPlot
안시성 영화에서 당나라 군사 수는 몇 명이지?	findPlot
영화 안시성에서 주연은 누구누구지?	getCast
영화 안시성에서 조연은 누가나왔어?	getCast
공성전 영화 뭐있냐?	findMovie
공성전 하는 영화는?	findMovie
배우 남주혁이 나온 사극	findMovie
배우 남주혁이 나온 영화	findMovie
엄태구가 맡은 역할은?	getCast
배우 엄태구가 맡은 역할은?	getCast
여장수가 나오는 영화는?	findMovie
여장수가 나오는 사극은?	findMovie
흥미진진한 영화	recommend
흥미진진한 영화는?	recommend
고증을 잘 한 영화는?	recommend
역사 고증을 잘 한 영화 뭐있어?	recommend
스펙터클한 영화	recommend
스펙터클한 영화 보여줘	recommend
두번봐도 좋은 영화는?	recommend
두번보고싶은 영화는?	recommend
진짜재밌는 영화는?	recommend
3시간 이상 러닝타임이 있는 영화가 뭐가 있어?	findMovie
우주가 나오는 명작을 추천해줘	recommend
놀란이 만든 영화 중에 우주가 배경인 영화가 뭐 였지	findMovie
앤 해서웨이가 나오는 영화가 뭐가 있지	findMovie
인터스텔라 줄거리를 알려줘	getPlot
인터스텔라 포스터를 보여줘	getPoster
인터스텔라 예고편 링크좀	getTrailer
인터스텔라 예고편 링크 좀 알려줘	getTrailer
인터스텔라 예고편 보여줘	getTrailer
인터스텔라 배우는 누가 있어?	getCast
인터스텔라 줄거리를 아니?	getPlot
인터스텔라 영화라고 알아	getPlot
블랙홀이 나오는 영화가 무엇이 있을까?	findMovie
크리스토퍼 놀란이 만든 영화는 무엇이 있어?	findMovie
2001 스페이스 오디세이와 같은 느낌의 영화는 무엇이 있을까?	findSimilar
2001 스페이스 오디세와 비슷한 영화를 추천해줘	findSimilar
2001 스페이스 오디세이 같은 영화가 또 있을까?	findSimilar
시각적으로 뛰어난 영화가 무엇이 있을까	recommend
아이맥스에서 꼭 봐야할 영화가 있다면?	recommend
IMAX에서 보기 좋은 영확가 있다면?	recommend
그래비티 같은 영화가 무엇이 있을까?	findSimilar
2014년에 개봉한 영화 중에 우주가 나오는 영화가 뭐였지?	findMovie
우주가 나오는 영화 알려줘	findMovie
우주가 나오는 영화 중에 하나만 추천해줘	findMovie
가족끼리 보기 좋은 우주 관련된 영화가 뭐가 있을까?	recommend
가족끼리 볼만한 영화가 뭐가 있을까?	recommend
블랙홀이 나오는 영화가 뭐였지?	findMovie
경이로운 영화가 있다면?	recommend
인셉션 만든 감독이 만든 영화 뭐있어?	findMovie
시공간과 관련된 영화가 있다면?	findMovie
시공관과 관련된 영화 추천해줘	recommend
인터스텔라를 본 사람들이 추천하는 영화는 뭐가 있을까?	recommend
인터스텔라 개봉일자 알려줘	getOpenDate
인터스텔라 개봉일자 알아?	getOpenDate
완전 쩌는 우주 관련된 인생 영화 추천해줘	recommend
우주 관련된 인생영화 추천해줘	recommend
우주 관련된 인생 영화 추천 좀	recommend
웜홀이 나오는 영화 뭐가 있지	findMovie
웜홀과 블랙홀이 나오는 영화가 뭐가 있지	findMovie
웜홀 나오는 영화 추천 좀	recommend
웜홀 나오는 영화 알려줘	findMovie
신비스러운 영화 알려줘	recommend
시간이 금방가는 영화 알려줘	recommend
몰입감 최고인 영화 알려줘	recommend
과학과 연관 깊은 영화 알려줘	findMovie
중력 방정식이 나오는 영화가 뭐였지?	findMovie
딸과 아버지를 주제로 하는 영화 알려줘	findMovie
가족애를 다룬 영화 알려줘	findMovie
최근에 나온 우주 관련된 영화 알려줘	findMovie
최근에 나온 SF 영화 알려줘	findMovie
최근에 나온 영화 중에 재개봉한 영화 알려줘	findMovie
시간 차원이 나오는 영화가 무엇이 있을까	findMovie
물리학과 관련된 영화가 뭐 있어?	findMovie
매튜 맥커너히가 나오는 영화 알려줘	findMovie
주인공 이름이 쿠퍼인 영화가 뭐 였지	findMovie
영화에 우주와 로봇이 나오는 영화 알려줘	findMovie
맷 데이먼이 나오는 우주 영화 알려줘	findMovie
맷데이먼이 나오는 SF 영화 알려줘	findMovie
마이클 케인이 나오는 영화 알려줘	findMovie
중력 방정식이 나오는 영화 알려줘	findMovie
Interstellar 영화 러닝 타임이 어떻게 돼?	getRunningTime
Interstellar 영화 등급이 어떻게 돼?	getGrade
인터스텔라 영화 공식사이트 알려줘	getOfficialSite
신비롭고 놀라운 영화가 뭐가 있을까	recommend
파도가 덮치는 영화 뭐였지	findMovie
인터스텔라 주인공 이름이 뭐야?	findPerson
인터스텔라 여주인공 이름이 뭐야?	findPerson
인터스텔라에 나오는 인물들 이름 좀 알려줘	getCast
소름끼치는 영화 알려줘	recommend
시각적으로 압도되는 영화가 있을까?	recommend
네이버 영화에 인터스텔라 검색해줘	search
다음 영화에 인터스텔라 검색해줘	search
구글에 인터스텔라 검색해줘	search
유튜브에 인터스텔라 검색해줘	search
유튜브에서 인터스텔라 예고편 좀	getTrailer
유튜브에서 인터스텔라 예고편 링크 알려줘	getTrailer
구글에 Interstellar 영화 검색해줘	search
상상력이 뛰어난 영화가 무엇이 있을까?	recommend
상상력이 뛰어난 영화 알려줘	recommend
상상력이 뛰어난 영화 추천 좀 해줘	recommend
외계인이 안나오는 우주 영화 알려줘	findMovie
외계인이 안나오는 우주 배경의 영화 알려줘	findMovie
imax에서 꼭 봐야할 영화가 있다면?	recommend
imax에서 꼭 봐야할 영화 알려줘	recommend
부녀가 나오는 우주 배경 영화 알려줘	findMovie
부녀가 나오는 영화 알려줘	findMovie
우주 나오는 경이로운 영화 추천해줘	recommend
다크나이트 만든 감독이 만든 영화 다 알려줘	findMovie
다크나이트 만든 감독이 만든 우주 배경의 영화가 뭐였지?	findMovie
인터스텔라 감독이 누구야?	findPerson
인터스텔라 누가 만들었어?	findPerson
인터스텔라 만든 감독은 누구야?	findPerson
우주가 나오는 인생영화 추천해줘	recommend
SF 휴먼 드라마 뭐가 있을까	findMovie
5년 안에 개봉한 영화 중에 우주 나오는 영화 다 알려줘	findMovie
5년 안에 개봉한 영화 중에 크리스토퍼 놀란이 만든 영화 알려줘	findMovie
우주가 나오는 볼만한 영화 알려줘	findMovie
영상미 좋은 영화	recommend
영상미 좋은 영화 뭐가 있을까?	recommend
영상미 좋은 영화 추천해줘	recommend
그래픽 좋은 영화 	recommend
그래픽 좋은 영화 뭐 있어?	recommend
그래픽 좋은 영화 알려줘	recommend
겨울왕국 같은 영화 알려줘	findSimilar
OST 좋은 영화 	recommend
OST 좋은 영화 뭐 있어?	recommend
노래가 좋은 영화 	recommend
노래가 좋은 영화 알려줘 	recommend
OST 음악 좋은 영화 알려줘	recommend
환상적인 OST 들을 수 있는 영화 알려줘	recommend
흥행한 OST 들을 수 있는 영화 	recommend
동심을 자극하는 영화	recommend
동심을 자극하는 영화 알려줘 	recommend
아름답고 감동적인 영화 	recommend
애들이 많이 보는 영화 	recommend
애들이 많이 보는 영화 뭐 있어?	recommend
애들이 좋아할만한 영화	recommend
애들이 좋아할만한 영화 뭐 있어?	recommend
딸 아이랑 보기 좋은 영화 알려줘	recommend
눈이라는 소재의 영화 뭐 있어?	findMovie
예쁜 캐릭터의 영화 뭐 있어?	recommend
여성 캐릭터가 예쁜 영화 	recommend
여성 캐릭터가 예쁜 영화 알려줘 	recommend
캐릭터가 매력적인 영화 	recommend
캐릭터가 매력적인 영화 알려줘 	recommend
스케일이 큰 영화 	recommend
스케일이 큰 영화 알려줘 	recommend
울컥하는 영화 알려줘	recommend
겨울에 보기 좋은 영화 알려줘 	recommend
마법 쓰는 영화 알려줘 	findMovie
스토리가 좋은 영화 	recommend
스토리가 좋은 영화 알려줘 	recommend
내용이 좋은 영화	recommend
내용이 좋은 영화 뭐 있어?	recommend
자매 이야기 나오는 영화 	findMovie
자매 이야기 나오는 영화 알려줘	findMovie
따뜻한 자매 이야기 나오는 영화 	recommend
따뜻한 자매 이야기 나오는 영화 뭐 있어?	recommend
따뜻한 자매 이야기 나오는 영화 알려줘 	recommend
여운이 남는 영화	recommend
여운이 남는 영화 알려줘 	recommend
마음이 따뜻해지는 영화	recommend
마음이 따뜻해지는 영화 뭐 있어	recommend
마음이 따뜻해지는 영화 알려줘	recommend
사랑을 주제로한 영화 	recommend
사랑을 주제로한 영화 알려줘 	recommend
라푼젤 같은 영화 	findSimilar
라푼젤 같은 영화 알려줘 	findSimilar
캐릭터가 귀여운 영화 	recommend
겨울왕국은 언제 개봉했어? 	getOpenDate
겨울왕국 개봉일 	getOpenDate
겨울왕국 개봉일이 언제야?	getOpenDate
겨울왕국은 어느 나라 영화야?	getMaker
겨울왕국 만든 제작사 알려줘	getMaker
겨울왕국 관람가 	getGrade
겨울왕국 관람가는 몇 세?	getGrade
디즈니 영화 추천해줘 	recommend
디즈니 영화 알려줘 	findMovie
볼만한 디즈니 영화 있나?	recommend
최근 개봉한 디즈니 영화	findMovie
겨울왕국 감독 누구야?	findPerson
겨울왕국 만든 감독 누구야	findPerson
겨울왕국 감독의 다른 작품은?	findMovie
겨울왕국 감독의 다른 작품 알려줘	findMovie
크리스 벅 감독의 다른 작품은?	findMovie
크리스 벅 감독이 찍은 다른 영화	findMovie
크리스 벅 감독이 찍은 다른 영화 알려줘 	findMovie
겨울왕국 엘사 목소리 누구?	findPerson
겨울왕국 안나 목소리 누구?	findPerson
겨울왕국 성우가 누구야?	findPerson
뮤지컬 영화 추천해줘	findMovie
뮤지컬 영화 뭐가 있을까?	findMovie
겨울왕국 개봉시간은?	getOpenDate
겨울왕국 영문제목은 뭐야	findMovie
크리스틴 벨이 출연한 영화가 뭐 있어?	findMovie
크리스틴 벨이 출연한 영화	findMovie
2017년 크리스틴 벨이 출연한 영화는 뭐야?	findMovie
3D로 볼수 있는 영화 	findMovie
3D로 볼만한 영화 뭐 있어?	recommend
3D로 볼수 있는 영화 추천해줘	findMovie
쓰리디로 볼 수 있는 영화	findMovie
쓰리디로 볼수 있는 영화 뭐 있어?	findMovie
쓰리디로 볼 수 있는 영화 추천해줘 	findMovie
볼만한 애니메이션 영화 알려줘 	recommend
볼만한 애니메이션 영화	recommend
볼만한 애니메이션 영화 뭐 있어?	recommend
볼만한 가족 영화 알려줘 	recommend
볼만한 가족 영화	recommend
볼만한 가족 영화 뭐 있어?	recommend
볼만한 미국 영화 뭐 있어?	recommend
재밌는 미국 영화 뭐 있어?	recommend
재밌는 판타지 영화 뭐 있어?	recommend
볼만한 판타지 영화 	recommend
재밌는 코미디 영화 알려줘 	recommend
재밌는 코미디 영화 뭐 있어?	findMovie
2013년에 볼만한 영화 	recommend
2013년 1월에 개봉한 영화 	findMovie
2013년에 100만 관객 넘은 영화 	findMovie
2013년에 100만 관객 넘은 영화 추천해줘	recommend
2013년에 100만 관객 넘은 영화 뭐 있어 	findMovie
어렸을 때 본 무서운 영화 알려줘	recommend
추억의 공포 영화 추천해줘	recommend
고딩 때 나왔던 무서운 영화가 뭐였지?	findMovie
살면서 본 제일 무서운 영화 뭐있어?	recommend
볼만한 영화 추천좀	recommend
볼만한 영화 있어	recommend
살면서 본 무서운 영화 추천 해줘	recommend
동양 공포 영화 부탁해	findMovie
동양 공포 영화 알려줘	findMovie
동양스타일의 공포 영화 뭐 있을까?	recommend
동양 스타일 공포영화 좀 추천 해줘	recommend
동양 식 공포영화 뭐있어?	findMovie
주인공 안죽은 공포영화 뭐였더라?	findMovie
무서운 외국 영화 뭐있지	recommend
무서운 외국영화 알려줘	recommend
무서운 태국영화 추천해줘	recommend
무서운 태국 영화 있어?	recommend
태국 영화 추천해줘	recommend
태국 영화 유명한거 추천해줘	recommend
태국 영화 유명한거 알려줘	recommend
태국 영화 어떤거 있어?	findMovie
재밌는 태국영화 뭐있어?	recommend
잘만든 태국영화 알려줘	recommend
적당한 무서운 영화 있을까	recommend
적당히 볼만한 무서운 영화 있어?	recommend
고전 공포 영화 추천 부탁해	recommend
고전 공포영화 알려줘	findMovie
1차원 적인 공포 영화있어?	recommend
최고의 공포영화 알려줘	recommend
최고라고 생각하는 공포 영화 말해줘	recommend
최고의 공포 영화라고 생각하는거 있니	recommend
계속 놀래키는 영화 알아	recommend
중간에 깜짝깜짝 놀라는 영화있을까?	recommend
깜짝 놀래키는 영화 알려줘	recommend
후회 안할만한 공포영화 있어	recommend
끝에 반전이 있는 영화 알려줘	recommend
결말 보면 무섭다기 보다는 슬픈 영화 알려줘	recommend
결말이 찝찝한 무서운 영화 아니	recommend
결말에 슬픈 공포 영화 뭐였지?	recommend
컨저링 같은 영화 알려줘	findSimilar
컨저링이 낫다고 생각드는 영화 알려줘	recommend
컨저링 처럼 무서운 영화 뭐있어?	findSimilar
애나벨 같이 무서운 영화 추천좀 해줘	findSimilar
애나벨 같은 영화 알려줘	findSimilar
주온 처럼 밤이 무서워지는 영화 추천좀 해줘	findSimilar
주온 떠올리는 영화 말해줘	findSimilar
주온보다 심한 영화 있어	findSimilar
그루지 같은 영화 알려줘	findSimilar
그루지 같이 무서운 영화 있니	findSimilar
링 같은 영화 알려줘	findSimilar
링처럼 오래된 영화 뭐있지	findSimilar
링 처럼 잠못자는 영화 추천좀	findSimilar
마지막이 기억에 남는 영화 알려줘	recommend
마지막 장면이 인상깊은 영화 알려줘	recommend
꼭 보면 좋을 공포 영화 부탁해	recommend
지금 보면 좋을 영화 추천해줘	recommend
꼭 봐야하는 공포 영화 있을까	recommend
예전에 봤던 공포 영화 뭐였더라	recommend
시대를 막론한 일등 공포영화 추천좀	recommend
결말이 보기 힘든 영화 추천해줘	recommend
너무 무서워서 결말을 못보는 영화 있어?	recommend
보다가 무서워 우는 영화 있어	recommend
보다가 우는 무서운 영화 알려줘	recommend
주인공이 나쁜 놈인 영화 궁금해	recommend
주인공이 알고보면 나쁜놈 이었던 영화 말해줘	recommend
뺑소니 치는 영화 뭐였지	findMovie
귀신이 씌이는 영화 뭐였더라	findMovie
심령사진 찍는 영화 알려줘	findMovie
사진 현장을 찾는 영화 뭐였지	findMovie
귀신이 자살시키는 영화 아니	findMovie
주변인이 자살하는 영화 알려줘	findMovie
대학 동기 끼리 싸우는 영화 뭐였더라	findMovie
해피엔딩이 아닌 영화 말해줘	recommend
귀신이 복수 하는 영화 알려줘	findMovie
사진에 귀신이 찍히는 영화 알려줘	findMovie
소리지르면서 보기 좋은 영화좀 추천해줘	recommend
귀신이 무섭게 생긴 영화 말해줘	recommend
스토리는 진부해도 연출은 기가막힌 영화 알려줘	recommend
호러의 정석인 영화 추천해줘	recommend
짜증날 정도로 무서운 영화 알려줘	recommend
동양 귀신 나오는 영화 알려줘	findMovie
혼자보기 좋은 영화 있어	recommend
여자친구랑 보기 좋은 무서운 영화 알려줘	recommend
호러영화 유명한거 알려줘	recommend
웰메이드 호러영화 추천 부탁해	recommend
비주얼부터 무서운 공포영화 추천해줘	recommend
비주얼이 무서운 영화 보여줘	recommend
공포이야기 종합선물세트 영화 있어	recommend
잠 못자게 하는 공포영화 알려줘	recommend
잠 못자는 공포영화 부탁해	recommend
손에 땀나는 공포영화 있어	recommend
손에 땀쥐게 하는 공포영화 말해줘	recommend
긴장감 있는 공포영화 있니	recommend
감독의 노력이 돋보이는 영화 있을까	recommend
감독의 아이디어가 돋보이는 영화 알려줘	recommend
소름돋는 영화 추천해줘	recommend
소름돋는 영화 있을까	recommend
한국인 들이 좋아하는 공포 영화 추천좀	recommend
한국 정서에 어울리는 공포영화 말해줘	recommend
조진웅씨 나오는 영화가 뭐야?	findMovie
조진웅이 나오는 영화 말해줘	findMovie
조진웅이 나오는 영화 알려줘	findMovie
조진웅 나오는 영화	findMovie
영화중에 조진웅 나오는 영화	findMovie
주연이 조진웅인 영화 알려줘	findMovie
주연이 조진웅인 영화 말해줘	findMovie
주연이 조진웅인 영화 찾아줘	findMovie
주연이 조진웅인 영화 말해봐	findMovie
주연이 조진웅인 영화 	findMovie
주연이 조진웅인 영화 제목은?	findMovie
주연이 조진웅인 영화 이름은?	findMovie
주연이 조진웅인 영화는?	findMovie
조진웅이 주연인 영화는?	findMovie
조진웅이 주인공인 영화는?	findMovie
조진웅이 주연인 영화 알려줘	findMovie
조진웅이 주연인 영화 말해봐	findMovie
조진웅이 주연인 영화 얘기해줘	findMovie
조진웅이 주연인 영화 찾아줘	findMovie
믿고 보는 조진웅 나오는 영화 알려줘	recommend
조진웅 연기가 좋은 영화 알려줘	recommend
조진웅 연기가 좋은 영화 말해줘	recommend
조진웅 연기가 좋은 영화 찾아줘	recommend
조진웅 연기가 좋은 영화 뭐야?	recommend
조진웅 연기 잘한 작품이 뭐야?	recommend
조진웅이 연기 잘한 작품 이름은?	recommend
조진웅이 출연한 작품 알려줘	findMovie
조진웅이 출연한 작품 말해줘	findMovie
잠오기 좋은 영화가 뭐야?	recommend
잠 잘오는 영화	recommend
영화보다가 잠오는 영화	recommend
집에서 볼만한 영화	recommend
잠오기 좋은 영화 말해봐	recommend
잠오기 좋은 영화 알려줘	recommend
보다가 잠오는 영화	recommend
잠오기 좋은 영화 추천해줘	recommend
긴장감 있는 영화	recommend
반전에 반전으로 놀라는 영화	recommend
스토리가 엉성한 영화	recommend
최악의 영화 뭐가있어?	recommend
조조로 보기 짜증나는 영화	recommend
스토리가 부족한 영화?	recommend
믿고 봤는데 실망한 영화	recommend
배우들의 연기가 좋은 영화	recommend
배우들의 연기만 좋은 영화	recommend
찝찝한 영화	recommend
보고나서 우울해지는 영화	recommend
나까지 우울한 영화	recommend
새롭지 않은 영화	recommend
재미없는 영화	recommend
스토리가 새롭지 않은 영화	recommend
새롭지 않은 스토리의 영화	recommend
다 보고 나면 기가 빠지는 영화	recommend
내용 구성이 이도 저도 아닌 영화	recommend
생각보다 별로인 영화	recommend
별 한개도 아까운 영화	recommend
이해가지 않는 영화	recommend
노잼 영화	recommend
노잼 영화 알려줘	recommend
노잼 영화 추천해줘	recommend
노잼영화 말해봐	recommend
노잼영화 뭐가 있어?	recommend
시간이 소중함을 알려주는 영화	recommend
보고나서 찝찝한 영화	recommend
덜 닦은 느낌나는 영화	recommend
스릴러 영화 찾아줘	recommend
스릴러 영화 추천	recommend
스릴러 작품 추천	recommend
스릴러 영화 알려줘	recommend
스릴러 작품 알려줘	recommend
스릴러 영화 말해줘	recommend
스릴러 작품 얘기해줘	recommend
스릴러 영화 얘기해줘	recommend
스릴러 매니아가 좋아할 영화	recommend
범죄 스릴러의 재미를 살려낸 영화	recommend
스릴러 장르 영화 알려줘	recommend
장르가 스릴러인 영화 말해줘	recommend
장르가 스릴러인 영화 추천해줘	recommend
장르가 스릴러인 영화 뭐있어?	recommend
장르가 스릴러인 영화 하나만	recommend
장르가 스릴러인 영화 알려줘	recommend
스릴러 장르 영화 말해봐	recommend
스릴있는 영화 	recommend
스릴있는 영화 알려줘	recommend
스릴있는 영화 말해봐	recommend
스릴있는 영화 추천해줘	recommend
스릴있는 영화 제목?	recommend
반전 영화 추천좀	recommend
반전 영화 알려줘	recommend
반전이 완전 좋은 영화 알려줘	recommend
반전의 반전을 거듭하는 영화 알려줘	recommend
반전 영화 말해줘	recommend
반전이 완전 좋은 영화 얘기해줘	recommend
반전이 있는 영화 뭐가 있을까?	recommend
빙빙 꼬아논 영화 알려줘	recommend
신구 나오는 영화 추천해줘	recommend
신구 나오는 영화 알려줘	findMovie
신구 나오는 영화 말해봐	findMovie
신구가 주인공으로 나오는 영화가 뭐야	findMovie
신구 주연인 영화는 말해봐	findMovie
신구 주인공인 영화는 말해봐	findMovie
신구 선생님 출연하는 작품 알려줘	findMovie
신구 선생님이 나오는 작품 말해줘	findMovie
신구 선생님이 출연하시는 작품 말해봐	findMovie
국내 15세 관람가 영화 알려줘	findMovie
국내 15세 관람가 영화 말해봐	findMovie
국내 15세 관람가 영화 뭐가 있어?	findMovie
국내 15세 관람가 영화 추천해줘	recommend
국내 15세 영화 알려줘	findMovie
국내 15세 영화 말해봐	findMovie
국내 15세 영화 뭐있어?	findMovie
국내 15세 영화	findMovie
국내 15세 관람가 영화	findMovie
2017년에 개봉한 영화 알려줘	findMovie
2017년에 개봉한 영화 말해봐	findMovie
2017년에 개봉한 영화 추천해줘	recommend
2017년에 나온 영화 제목을 알려줘	findMovie
2017년에 개봉한 영화	findMovie
2017년작 영화 알려줘	findMovie
2017년작 영화 말해봐	findMovie
2017년작 영화 추천해줘	recommend
2017년에 망한영화 추천해줘	recommend
해빙에 나온 주인공이 누구야	findMovie
해빙에 나온 주인공 이름이 뭐야	findMovie
해빙에 나온 주연이 누구야	findMovie
해빙에 나온 주연 이름은?	findMovie
해빙은 몇분짜리 영화야?	findMovie
해빙의 러닝타임은?	getRunningTime
해빙 몇시간짜리 영화야?	getRunningTime
해빙 플레이타임	getRunningTime
해빙 러닝타임 알려줘	getRunningTime
해빙은 몇세 관람가야?	getGrade
해빙 나이제한 알려줘	getGrade
해빙 나이제한 몇살이야?	getGrade
해빙은 몇세 영화야?	getGrade
영화 해빙의 장르가 뭐야?	getGanre
해빙은 무슨 영화야?	getGanre
해빙의 장르는?	getGanre
영화 해빙의 장르 알려줘	getGanre
해빙 장르가 뭐야?	getGanre
해빙 개봉년도 알려줘	getOpenDate
해빙은 몇년도에 개봉했어?	getOpenDate
해빙이 개봉한 년도는 언제야?	getOpenDate
해빙이 나온날이 언제야?	getOpenDate
해빙 나온날?	getOpenDate
해빙이 나온날 말해줘	getOpenDate
해빙이 개봉한날 말해줘	getOpenDate
해빙 주연 알려줘	getCast
해빙 등장인물 이름은?	getCast
해빙 나온 사람이 누구야?	getCast
해빙 나온사람이 누구여?	getCast
해빙에 누가 나왔어?	getCast
해빙에 누가 나왔는지 알아?	getCast
해빙에 나온 사람이 누구야?	getCast
해빙에 나온 사람이 누가있어?	getCast
가장 최근에 개봉한 영화	findMovie
우주가 배경인 영화 알려줘	findMovie
인터스텔라 공식 홈페이지 주소 말해줘	getOfficialSite
겨울 왕국 공식 웹페이지 알고 싶다	getOfficialSite
안시 성공식 사이트 알고 싶어	getOfficialSite
라라랜드 영화 공식 홈페이지 알려줘	getOfficialSite
셔터 영화 홈페이지 주소가 뭐야?	getOfficialSite
해빙 배급사 홈페이지 주소는?	getOfficialSite
인피니티와 공홈 	getOfficialSite
셔터 영화 사이트 알고 싶다	getOfficialSite
안시 성공식 홈페이지 주소 말해줘	getOfficialSite
인피니티 워 영화 홈페이지 알고 싶어	getOfficialSite
라라랜드 공식 홈페이지 주소가 뭐야?	getOfficialSite
겨울 왕국 공홍 알려줘	getOfficialSite
인터스텔라 공식 홈페이지 주소는?	getOfficialSite
해빙 배급사 홈페이지 	getOfficialSite
인피니티 워 공식 웹페이지 주소가 뭐야?	getOfficialSite
셔터공식 사이트 주소가 뭐야?	getOfficialSite
해빙공식웹페이지	getOfficialSite
라라랜드 영화 홈페이지 주소 말해줘	getOfficialSite
겨울왕국 배급사 홈페이지 알려줘	getOfficialSite
인터스텔라영화 공식 홈페이지 알고싶어	getOfficialSite
안시성 공식 홈페이지 알고싶다	getOfficialSite
인피니티워 공홈 주소는?	getOfficialSite
라라랜드영화 사이트 	getOfficialSite
겨울왕국공식 홈페이지 주소가 뭐야?	getOfficialSite
셔터공식 사이트 알고싶다	getOfficialSite
인피니티워공식웹페이지 주소 말해줘	getOfficialSite
해빙 공식 홈페이지 알고싶어	getOfficialSite
안시성영화 사이트 주소는?	getOfficialSite
인터스텔라 배급사 홈페이지 알려줘	getOfficialSite
인터스텔라공식 홈페이지 주소 말해줘	getOfficialSite
안시성 영화 홈페이지 알고싶다	getOfficialSite
라라랜드 공식 홈페이지 주소가 뭐야?	getOfficialSite
인터스텔라공식 사이트 주소 말해줘	getOfficialSite
인피니티워영화 공식 홈페이지 알려줘	getOfficialSite
해빙공식웹페이지 주소는?	getOfficialSite
셔터 배급사 홈페이지 	getOfficialSite
겨울왕국공식 홈페이지 알고싶어	getOfficialSite
셔터 공홈 알고싶어	getOfficialSite
인피니티워영화 사이트 주소가 뭐야?	getOfficialSite
겨울왕국영화 공식 홈페이지 알고싶다	getOfficialSite
안시성 배급사 홈페이지 알려줘	getOfficialSite
인터스텔라 공식 홈페이지 	getOfficialSite
해빙공식 사이트 주소는?	getOfficialSite
라라랜드 영화 홈페이지 주소 말해줘	getOfficialSite
인피니티워영화 사이트 알고싶다	getOfficialSite
해빙공식 사이트 알고싶어	getOfficialSite
라라랜드 영화 홈페이지 주소는?	getOfficialSite
겨울왕국영화 공식 홈페이지 	getOfficialSite
셔터 공홈 주소가 뭐야?	getOfficialSite
안시성 공식 홈페이지 알고싶다	getOfficialSite
인피니티워공식웹페이지 주소 말해줘	getOfficialSite
인터스텔라 배급사 홈페이지 알려줘	getOfficialSite
인피니티워공식 홈페이지 알고싶다	getOfficialSite
셔터영화 사이트 주소 말해줘	getOfficialSite
겨울왕국영화 사이트 알려줘	getOfficialSite
인터스텔라 영화 홈페이지 	getOfficialSite
안시성 공식 홈페이지 알고싶어	getOfficialSite
해빙공식웹페이지 주소가 뭐야?	getOfficialSite
라라랜드공식 사이트 주소는?	getOfficialSite
라라랜드 공홈 주소가 뭐야?	getOfficialSite
인피니티 워 영화 홈페이지 URL 알려줘	getOfficialSite
라라랜드 공식 사이트 검색해	search
셔터 배급사 홈페이지 알고 싶어	getOfficialSite
인터스텔라 공식 홈페이지 뭐지?	getOfficialSite
해빙 공홈 검색해줘	search
겨울 왕국 공식 웹페이지 URL	getOfficialSite
안시성 영화 사이트 URL 알려줘	getOfficialSite
인피니티 워 영화 공식 홈페이지 URL	getOfficialSite
라라랜드 공식 홈페이지 알고 싶어	getOfficialSite
해빙 영화 사이트 뭐지?	getOfficialSite
안시 성공식 홈페이지 검색해줘	search
겨울 왕국 배급사 홈페이지 검색해	search
인터스텔라 공식 홈페이지 검색해줘	search
셔터 공식 사이트 검색해줘	search
안시 성공식 웹페이지 URL 알려줘	getOfficialSite
인피니티 워 영화 공식 홈페이지 알고 싶어	getOfficialSite
라라랜드 공식 홈페이지 URL	getOfficialSite
안시성 배급사 홈페이지 검색해줘	search
겨울 왕국 공식 사이트 뭐지?	getOfficialSite
셔터 영화 사이트 URL 알려줘	getOfficialSite
해빙 검색해줘	search
인터스텔라 공식 홈페이지 알고 싶어	getOfficialSite
인터스텔라 공식 웹페이지 URL	getOfficialSite
해빙 영화 홈페이지 뭐지?	getOfficialSite
셔터 배급사 홈페이지 URL 알려줘	getOfficialSite
인피니티 워 공식 홈페이지 검색해줘	search
안시성 영화 공식 홈페이지 검색해	search
겨울 왕국 공식 사이트 알고 싶어	getOfficialSite
라라랜드 영화 사이트 URL 알려줘	getOfficialSite
인터스텔라 공홈 알고싶어	getOfficialSite
해빙영화 공식 홈페이지 검색해줘	search
라라랜드공식 홈페이지 URL 알려줘	getOfficialSite
인피니티워공식 웹페이지 URL 	getOfficialSite
셔터 공홈 뭐지?	getOfficialSite
인터스텔라 영화 홈페이지 검색해	search
겨울왕국영화 사이트 알고싶어	getOfficialSite
안시성공식 사이트 URL 알려줘	getOfficialSite
안시성 배급사 홈페이지 검색해줘	search
라라랜드 공식 홈페이지 알고싶어	getOfficialSite
해빙공식 홈페이지 검색해	search
셔터영화 사이트 URL	getOfficialSite
겨울왕국공식웹페이지뭐지?	getOfficialSite
인피니티워영화 공식 홈페이지 검색해줘	search
인터스텔라 공홈 URL 알려줘	getOfficialSite
라라랜드 영화 홈페이지 알고싶어	getOfficialSite
안시성공식웹페이지검색해	search
인터스텔라 공홈 검색해줘	search
해빙영화 공식 홈페이지 뭐지?	getOfficialSite
겨울왕국 배급사 홈페이지 URL 알려줘	getOfficialSite
인피니티워 공식 홈페이지 URL	getOfficialSite
셔터 영화 홈페이지 알고싶어	getOfficialSite
라라랜드공식 홈페이지 URL	getOfficialSite
겨울왕국공식 사이트 검색해	search
인피니티워영화 사이트 알고싶어	getOfficialSite
안시성 배급사 홈페이지 뭐지?	getOfficialSite
셔터공식 사이트 URL 알려줘	getOfficialSite
해빙공식 홈페이지 검색해줘	search
인터스텔라공식웹페이지뭐지?	getOfficialSite
라라랜드영화 사이트 뭐지?	getOfficialSite
셔터 공홈 알고싶어	getOfficialSite
안시성 배급사 홈페이지 검색해줘	search
라라랜드공식웹페이지뭐지?	getOfficialSite
해빙 공식 홈페이지 URL	getOfficialSite
셔터공식 홈페이지 URL 알려줘	getOfficialSite
인피니티워영화 공식 홈페이지 검색해	search
인터스텔라공식 사이트 알고싶어	getOfficialSite
겨울왕국 공홈 URL 알려줘	getOfficialSite
겨울왕국 영화 홈페이지 뭐지?	getOfficialSite
라라랜드영화 사이트 알고싶어	getOfficialSite
셔터 배급사 홈페이지 검색해줘	search
인터스텔라영화 사이트 URL	getOfficialSite
해빙공식 사이트 검색해	search
인피니티워 공홈 검색해줘	search
안시성공식 홈페이지 검색해	search
겨울왕국 공식 홈페이지 URL 알려줘	getOfficialSite
겨울왕국 영화 홈페이지 알고싶어	getOfficialSite
인피니티워 배급사 홈페이지 URL	getOfficialSite
셔터공식 사이트 뭐지?	getOfficialSite
안시성영화 공식 홈페이지 검색해	search
라라랜드공식웹페이지검색해줘	search
해빙 공홈 URL 알려줘	getOfficialSite
인터스텔라영화 사이트 URL 알려줘	getOfficialSite
셔터 공식 홈페이지 URL	getOfficialSite
해빙공식 홈페이지 검색해줘	search
안시성 배급사 홈페이지 뭐지?	getOfficialSite
인피니티워영화 공식 홈페이지 검색해	search
겨울왕국 영화 홈페이지 알고싶어	getOfficialSite
인터스텔라영화 사이트 검색해줘	search
라라랜드공식 사이트 검색해	search
인피니티워 공홈 URL 	getOfficialSite
라라랜드영화 공식 홈페이지 검색해줘	search
인피니티워공식 홈페이지 URL	getOfficialSite
인터스텔라 공식 홈페이지 URL 알려줘	getOfficialSite
겨울왕국 공홈 검색해	search
해빙영화 사이트 뭐지?	getOfficialSite
안시성 영화 홈페이지 알고싶어	getOfficialSite
셔터공식 사이트 검색해	search
인피니티워 배급사 홈페이지 URL	getOfficialSite
셔터공식 웹페이지 URL 알려줘	getOfficialSite
안시성영화 사이트 뭐지?	getOfficialSite
겨울왕국영화 공식 홈페이지 검색해줘	search
해빙공식웹페이지알고싶어	getOfficialSite
라라랜드 배급사 홈페이지 알고싶어	getOfficialSite
인터스텔라 공홈 검색해	search
라라랜드공식 사이트 검색해줘	search
셔터 시간 얼마지?	getRunningTime
라라랜드 상영 시간 알고 싶어	getRunningTime
해빙 러닝타임 몇 시간 ?	getRunningTime
안시성 시청하는데 드는 시간 몇 분?	getRunningTime
겨울 왕국 총 상영 시간 몇 시간 이지?	getRunningTime
인터스텔라 보는데 걸리는 시간 검색해줘	search
인피니티 워 시간 몇 분이지?	getRunningTime
라라랜드 총 상영 시간 알려줘	getRunningTime
셔터 러닝타임	getRunningTime
안시성 상영 시간 몇 시간 ?	getRunningTime
인터스텔라 시청하는데 드는 시간 몇 분이지?	getRunningTime
해빙 보는데 걸리는 시간 검색해줘	search
겨울 왕국 총 상영 시간 몇 분?	getRunningTime
인피니티 워 러닝타임 얼마지?	getRunningTime
인터스텔라 보는데 걸리는 시간 	getRunningTime
인피니티워 시간	getRunningTime
인터스텔라 시청하는데 드는 시간 알고싶어	getRunningTime
안시성 보는데 걸리는 시간 몇분?	getRunningTime
라라랜드 상영 시간 몇 시간 이지?	getRunningTime
겨울왕국 총 상영 시간 얼마지?	getRunningTime
해빙 러닝타임 알려줘	getRunningTime
셔터 상영 시간 검색해줘	search
안시성 시간몇 시간 ?	getRunningTime
해빙 러닝타임몇분이야	getRunningTime
인터스텔라 시청하는데 드는 시간 	getRunningTime
셔터 총 상영 시간 몇분이야	getRunningTime
인피니티워 보는데 걸리는 시간 몇 시간 이지?	getRunningTime
라라랜드 상영 시간 몇 시간 ?	getRunningTime
겨울왕국 시청하는데 드는 시간 검색해줘	search
라라랜드 보는데 걸리는 시간 얼마지?	getRunningTime
인터스텔라 총 상영 시간 몇 시간 이지?	getRunningTime
안시성 시간 검색해줘	search
인피니티워 러닝타임몇분이야	getRunningTime
해빙 시청하는데 드는 시간 몇분?	getRunningTime
셔터 보는데 걸리는 시간 얼마지?	getRunningTime
라라랜드 상영 시간 알려줘	getRunningTime
겨울왕국 총 상영 시간 	getRunningTime
해빙 시간알고싶어	getRunningTime
인피니티워 시청하는데 드는 시간 몇 시간 ?	getRunningTime
인터스텔라 상영 시간 몇 시간 이지?	getRunningTime
라라랜드 보는데 걸리는 시간 알려줘	getRunningTime
겨울왕국 러닝타임몇분이야	getRunningTime
셔터 시청하는데 드는 시간 	getRunningTime
안시성 보는데 걸리는 시간 검색해줘	search
인터스텔라 총 상영 시간 몇 시간 ?	getRunningTime
라라랜드 시청하는데 드는 시간 검색해줘	search
인피니티 워 러닝타임 몇 분?	getRunningTime
해빙 보는데 걸리는 시간 몇 시간 이지?	getRunningTime
인터스텔라 상영 시간 	getRunningTime
셔터 시간 알려줘	getRunningTime
겨울 왕국 총 상영 시간 몇 시간 ?	getRunningTime
안시성 보는데 걸리는 시간 얼마지?	getRunningTime
해빙 시간 알고 싶어	getRunningTime
셔터 러닝타임 몇 분이지?	getRunningTime
라라랜드 시청하는데 드는 시간 	getRunningTime
인터스텔라 총 상영 시간 알려줘	getRunningTime
인피니티 워 상영 시간 검색해줘	search
겨울 왕국 보는데 걸리는 시간 얼마지?	getRunningTime
안시성 시간 몇 시간 ?	getRunningTime
라라랜드 상영 시간 몇 시간 이지?	getRunningTime
인피니티 워 러닝타임 얼마지?	getRunningTime
해빙 상영 시간 몇 분이지?	getRunningTime
라라랜드 보는데 걸리는 시간 몇 시간 ?	getRunningTime
안시성 시청하는데 드는 시간 검색해줘	search
인터스텔라 총 상영 시간 알려줘	getRunningTime
겨울 왕국 시간 알고 싶어	getRunningTime
셔터 총 상영 시간 	getRunningTime
해빙 시청하는데 드는 시간 몇 시간 이지?	getRunningTime
인피니티 워 러닝타임 몇 분?	getRunningTime
안시성 보는데 걸리는 시간 	getRunningTime
셔터 시간 몇 분이지?	getRunningTime
인터스텔라 상영 시간 알려줘	getRunningTime
겨울 왕국 시청하는데 드는 시간 몇 분?	getRunningTime
라라랜드 보는데 걸리는 시간 몇 시간 이지?	getRunningTime
인터스텔라 총 상영 시간 검색해줘	search
안시성 시간몇분이야	getRunningTime
해빙 보는데 걸리는 시간 검색해줘	search
인터스텔라 총 상영 시간 알려줘	getRunningTime
겨울왕국 러닝타임얼마지?	getRunningTime
셔터 시청하는데 드는 시간 몇 시간 ?	getRunningTime
인피니티워 상영 시간 알고싶어	getRunningTime
라라랜드 총 상영 시간 	getRunningTime
인터스텔라 보는데 걸리는 시간 몇 시간 이지?	getRunningTime
해빙 러닝타임몇분?	getRunningTime
안시성 시간	getRunningTime
라라랜드 상영 시간 알고싶어	getRunningTime
겨울왕국 시청하는데 드는 시간 몇분이야	getRunningTime
셔터 러닝타임얼마지?	getRunningTime
인피니티워 시청하는데 드는 시간 알려줘	getRunningTime
인터스텔라 상영 시간 검색해줘	search
해빙 총 상영 시간 얼마지?	getRunningTime
안시성 시청하는데 드는 시간 알고싶어	getRunningTime
라라랜드 러닝타임 검색해줘	search
겨울왕국 시간몇 시간 ?	getRunningTime
인터스텔라 상영 시간 몇 시간 이지?	getRunningTime
셔터 보는데 걸리는 시간 몇분?	getRunningTime
인피니티워 시청하는데 드는 시간 몇분이야	getRunningTime
라라랜드 상영 시간 알려줘	getRunningTime
안시성 보는데 걸리는 시간 	getRunningTime
인피니티워 총 상영 시간 몇 시간 이지?	getRunningTime
해빙 시간몇분이야	getRunningTime
인터스텔라 러닝타임알고싶어	getRunningTime
겨울왕국 총 상영 시간 얼마지?	getRunningTime
셔터 총 상영 시간 	getRunningTime
겨울왕국 러닝타임 알려줘	getRunningTime
인피니티워 총 상영 시간 검색해줘	search
안시성 상영 시간 알려줘	getRunningTime
셔터 러닝타임알고싶어	getRunningTime
겨울왕국 시간몇 시간 이지?	getRunningTime
인터스텔라 보는데 걸리는 시간 몇 시간 ?	getRunningTime
해빙 시청하는데 드는 시간 몇분이야	getRunningTime
라라랜드 시간몇분?	getRunningTime
인터스텔라 러닝타임얼마지?	getRunningTime
해빙 보는데 걸리는 시간 	getRunningTime
안시성 총 상영 시간 검색해줘	search
겨울왕국 상영 시간 몇 시간 이지?	getRunningTime
인피니티워 시청하는데 드는 시간 얼마지?	getRunningTime
라라랜드 총 상영 시간 몇 시간 ?	getRunningTime
셔터 상영 시간 몇분이야	getRunningTime
셔터 시간알고싶어	getRunningTime
겨울왕국 러닝 타임 좀 알려줘	getRunningTime
해빙 상영 시간 몇 시간 ?	getRunningTime
셔터 러닝타임몇분이야	getRunningTime
라라랜드 보는데 걸리는 시간 얼마지?	getRunningTime
안시성 총 상영 시간 몇 시간 이지?	getRunningTime
인피니티워 시청하는데 드는 시간 알려줘	getRunningTime
인터스텔라 상영 시간 	getRunningTime
인터스텔라 시청하는데 드는 시간 검색해줘	search
라라랜드 총 상영 시간 알고싶어	getRunningTime
안시성 보는데 걸리는 시간 알고싶어	getRunningTime
셔터 시간몇 시간 이지?	getRunningTime
겨울왕국 러닝타임얼마지?	getRunningTime
인피니티워 총 상영 시간 몇분?	getRunningTime
해빙 상영 시간 몇분이야	getRunningTime
해빙 총 상영 시간 몇 시간 ?	getRunningTime
셔터 러닝타임	getRunningTime
겨울왕국 시청하는데 드는 시간 몇 시간 이지?	getRunningTime
안시성 시간몇분?	getRunningTime
라라랜드 총 상영 시간 알고싶어	getRunningTime
해빙 보는데 걸리는 시간 검색해줘	search
인피니티워 상영 시간 몇 시간 ?	getRunningTime
인터스텔라 러닝타임얼마지?	getRunningTime
인터스텔라 총 상영 시간 몇분이야	getRunningTime
라라랜드 시간 알려줘	getRunningTime
인피니티워 상영 시간 검색해줘	search
해빙 시청하는데 드는 시간 몇 시간 이지?	getRunningTime
셔터 보는데 걸리는 시간 	getRunningTime
겨울왕국 총 상영 시간 알려줘	getRunningTime
안시성 보는데 걸리는 시간 몇 시간 ?	getRunningTime
라라랜드 시청하는데 드는 시간 알고싶어	getRunningTime
안시성 시간몇분?	getRunningTime
셔터 보는데 걸리는 시간 몇분이야	getRunningTime
겨울왕국 상영 시간 알고싶어	getRunningTime
해빙 러닝타임 검색해줘	search
인피니티워 총 상영 시간 얼마지?	getRunningTime
인터스텔라 시청하는데 드는 시간 몇 시간 이지?	getRunningTime
라라랜드 시간	getRunningTime
안시성 시청하는데 드는 시간 알려줘	getRunningTime
겨울왕국 상영 시간 몇 시간 ?	getRunningTime
인피니티워 총 상영 시간 검색해줘	search
인터스텔라 보는데 걸리는 시간 몇분?	getRunningTime
해빙 러닝타임몇 시간 ?	getRunningTime
라라랜드 보는데 걸리는 시간 몇분이지?	getRunningTime
셔터 시청하는데 드는 시간 몇 시간 이지?	getRunningTime
안시성 러닝타임 알려줘	getRunningTime
인터스텔라 보는데 걸리는 시간 몇분이야	getRunningTime
인피니티워 시청하는데 드는 시간 몇 시간 ?	getRunningTime
안시성 상영 시간 	getRunningTime
겨울왕국 러닝타임얼마지?	getRunningTime
셔터 시간 검색해줘	search
해빙 총 상영 시간 몇 시간 이지?	getRunningTime
라라랜드 러닝타임 알려줘	getRunningTime
인피니티워 시간알고싶어	getRunningTime
라라랜드 보는데 걸리는 시간 몇분?	getRunningTime
인터스텔라 총 상영 시간 알려줘	getRunningTime
해빙 상영 시간 얼마지?	getRunningTime
겨울왕국 시청하는데 드는 시간 알고싶어	getRunningTime
셔터 총 상영 시간 몇분이야	getRunningTime
안시성 상영 시간 몇분?	getRunningTime
안시성시청하는데 드는 시간검색해줘	search
인터스텔라 남자 주인공 누구야?	findPerson
해빙 여주 이름	findPerson
인피니티 워 남주 알려줘	findPerson
안시성 연출자 검색해줘	search
라라랜드 맡은 배우 누구지?	findPerson
겨울 왕국 주인공 찾아줘	findPerson
셔터 영화 감독 이름이 뭐지?	findPerson
인피니티 워 여자 주인공 이름이 뭐야?	findPerson
인터스텔라 영화 감독 검색해	search
안시성 여주 누구지?	findPerson
셔터 남주 누구야?	findPerson
해빙 연출자 검색해	search
라라랜드 맡은 배우 이름이 뭐야?	findPerson
겨울 왕국 여자 주인공 알려줘	findPerson
라라랜드 주인공 이름	findPerson
안시성 맡은 배우 이름	findPerson
라라랜드 연출자 이름이 뭐야?	findPerson
인피니티워 주인공 검색해줘	search
셔터 여자 주인공 알려줘	findPerson
해빙 영화 감독 검색해	search
인터스텔라 여주 찾아줘	findPerson
겨울왕국 남주 누구야?	findPerson
겨울왕국 남자 주인공 누구지?	findPerson
셔터 영화 감독 이름이 뭐지?	findPerson
해빙 남주이름이 뭐지?	findPerson
인피니티워 여주 찾아줘	findPerson
라라랜드 남자 주인공 검색해줘	search
안시성 연출자 검색해	search
인터스텔라 여자 주인공 이름	findPerson
해빙 주인공 누구지?	findPerson
해빙 남자 주인공 찾아줘	findPerson
셔터 주인공 검색해	search
라라랜드 맡은 배우 누구지?	findPerson
인터스텔라 여자 주인공 알려줘	findPerson
겨울왕국 연출자 누구야?	findPerson
안시성 영화 감독 이름이 뭐지?	findPerson
인피니티워 남주 이름	findPerson
인피니티워 여주 이름이 뭐야?	findPerson
겨울왕국 영화 감독 검색해줘	search
해빙 남자 주인공 찾아줘	findPerson
셔터 주인공 알려줘	findPerson
인터스텔라 여자 주인공 이름이 뭐야?	findPerson
라라랜드 여주 이름	findPerson
안시성 남주 누구지?	findPerson
인피니티워 맡은 배우 검색해	search
겨울 왕국 여주 누구지?	findPerson
셔터 남주 이름이 뭐야?	findPerson
안시성 남자 주인공 검색해줘	search
라라랜드 주인공 찾아줘	findPerson
해빙 맡은 배우 누구야?	findPerson
인터스텔라 연출자 알려줘	findPerson
인피니티 워 영화 감독 이름	findPerson
인피니티 워 여자 주인공 검색해	search
해빙 주인공 이름이 뭐지?	findPerson
인터스텔라 여자 주인공 누구야?	findPerson
라라랜드 맡은 배우 이름이 뭐야?	findPerson
셔터 남자 주인공 검색해줘	search
겨울 왕국 여주 검색해	search
안시성 영화 감독 이름이 뭐지?	findPerson
인터스텔라 남주 이름	findPerson
안시성 여자 주인공 찾아줘	findPerson
라라랜드 여주 알려줘	findPerson
셔터 영화 감독 누구야?	findPerson
겨울왕국 맡은 배우이름이 뭐지?	findPerson
맡은 배우 이름 알려줘	findPerson
인터스텔라 남주 누구지?	findPerson
인피니티워 주인공 이름이 뭐야?	findPerson
해빙 연출자 검색해	search
인피니티워 남자 주인공 검색해줘	search
겨울왕국 남주 이름	findPerson
인터스텔라 여자 주인공 누구지?	findPerson
해빙 주인공 찾아줘	findPerson
안시성 영화 감독 이름이 뭐야?	findPerson
그 감독 누구야	findPerson
이 역할을 맡은 사람이 누구야	findPerson
이 역할 맡은 배우 누구야	findPerson
이 역할 맡은 배우 알려줘	findPerson
그 영화 배우 이름 알려줘	findPerson
감독의 이름을 알려줘	findPerson
조연출의 이름을 알려줘	findPerson
감독 이름 알려줘	findPerson
감독 이름 좀	findPerson
배우 이름 좀	findPerson
그 영화 배우 이름 좀	findPerson
그 영화 감독 이름 좀	findPerson
여주인공 누가 맡은거야	findPerson
여주인공 맡은 배우 누구야	findPerson
남주인공 누가 맡은거야	findPerson
남주인공 맡은 배우 알려줘	findPerson
맡은 배우 알려줘	findPerson
연기한 배우 알려줘	findPerson
셔터 연출자 알려줘	findPerson
라라랜드 남자 주인공 누구야?	findPerson
셔터 맡은 배우 검색해줘	search
겨울 왕국 영화 감독 검색해줘	search
해빙 맡은 배우 검색해	search
인터스텔라 연출자 누구야?	findPerson
라라랜드 남주 이름	findPerson
셔터 남자 주인공 이름이 뭐야?	findPerson
안시성 여주 이름이 뭐지?	findPerson
인피니티 워 여자 주인공 누구지?	findPerson
겨울 왕국 주인공 찾아줘	findPerson
인피니티 워 여자 주인공 알려줘	findPerson
인터스텔라 맡은 배우 검색해줘	search
안시성 영화 감독 찾아줘	findPerson
해빙 연출자 검색해	search
라라랜드 주인공 누구야?	findPerson
셔터 여주 이름	findPerson
인피니티 워 남주 누구지?	findPerson
셔터 연출자 누구지?	findPerson
겨울왕국 영화 감독 검색해줘	search
인피니티워 주인공 검색해	search
인터스텔라 맡은 배우이름이 뭐지?	findPerson
안시성 남주 이름이 뭐야?	findPerson
라라랜드 여주 알려줘	findPerson
해빙 여자 주인공 찾아줘	findPerson
라라랜드 남자 주인공 누구야?	findPerson
인터스텔라 연출자 이름	findPerson
인피니티워 여자 주인공 이름	findPerson
안시성 주인공 이름이 뭐지?	findPerson
해빙 남자 주인공 검색해	search
셔터 남주 누구지?	findPerson
겨울왕국 맡은 배우 찾아줘	findPerson
인터스텔라 영화 감독 검색해줘	search
라라랜드 주인공 이름이 뭐야?	findPerson
셔터 남자 주인공 찾아줘	findPerson
인터스텔라 연출자이름이 뭐지?	findPerson
해빙 여자 주인공 누구야?	findPerson
겨울왕국 맡은 배우 이름	findPerson
안시성 여주 검색해줘	search
인피니티워 남주 알려줘	findPerson
해빙 영화 감독 검색해	search
인터스텔라 주인공 누구지?	findPerson
겨울왕국 여자 주인공 검색해줘	search
헐크 맡은 배우 이름 알려줘	findPerson
캡틴아메리카 맡은 배우 이름 알려줘	findPerson
스파이더맨 맡은 배우 이름 알려줘	findPerson
주인공 배우 이름 알려줘	findPerson
그 주인공 맡은 배우가 누구야	findPerson
그 배역 밑은 배우 알려줘	findPerson
셔터 연출자 알려줘	findPerson
안시성 영화 감독 누구지?	findPerson
라라랜드 남주 검색해	search
인피니티워 남자 주인공 이름이 뭐야?	findPerson
라라랜드 맡은 배우 누구야?	findPerson
안시성 주인공 알려줘	findPerson
셔터 영화 감독 이름이 뭐지?	findPerson
인피니티워 남자 주인공 찾아줘	findPerson
엘사 맡은 성우 누구야	findPerson
연기한 배우 누구야	findPerson
연기를 누가 한거니	findPerson
맡은 배우 알려줘	findPerson
누가 맡은 거야	findPerson
엘사 누가 한거야	findPerson
배우가 누구야	findPerson
감독이 누구야	findPerson
누가 만든거야	findPerson
여주인공 이름이 뭐야	findPerson
겨울왕국 맡은 배우 누구지?	findPerson
라라랜드 여주 검색해	search
해빙 연출자 검색해줘	search
인터스텔라 남주 이름	findPerson
해빙 여자 주인공 누구야?	findPerson
라라랜드 영화 감독 이름이 뭐야?	findPerson
인피니티워 남주 이름	findPerson
안시성 연출자 이름이 뭐야?	findPerson
셔터 남자 주인공 검색해줘	search
겨울왕국 주인공 이름이 뭐지?	findPerson
인터스텔라 여자 주인공 알려줘	findPerson
겨울왕국 맡은 배우 누구지?	findPerson
겨울왕국 여자 주인공 누구야?	findPerson
안시성 영화 감독 이름	findPerson
라라랜드 주인공 이름이 뭐지?	findPerson
해빙 남주 찾아줘	findPerson
인터스텔라 남자 주인공 누구지?	findPerson
셔터 여주 검색해	search
인피니티워 연출자 검색해줘	search
해빙 맡은 배우 이름이 뭐야?	findPerson
안시성 여주 알려줘	findPerson
인터스텔라 연출자이름이 뭐지?	findPerson
겨울왕국 주인공 누구지?	findPerson
셔터 남자 주인공 알려줘	findPerson
인피니티워 남주 누구야?	findPerson
라라랜드 맡은 배우 이름	findPerson
겨울왕국 여자 주인공 검색해	search
인터스텔라 남주 이름	findPerson
겨울왕국 주인공 이름이 뭐지?	findPerson
안시성 맡은 배우 이름이 뭐야?	findPerson
해빙 연출자 검색해	search
라라랜드 영화 감독 누구야?	findPerson
인피니티워 여주 찾아줘	findPerson
셔터 남자 주인공 누구지?	findPerson
안시성 여자 주인공 알려줘	findPerson
인터스텔라 남주 검색해줘	search
해빙 연출자 이름이 뭐야?	findPerson
인피니티워 맡은 배우 이름	findPerson
셔터 남자 주인공 검색해줘	search
라라랜드 여주 검색해	search
겨울왕국 주인공 알려줘	findPerson
셔터 영화 감독 이름이 뭐지?	findPerson
인피니티워 맡은 배우 검색해줘	search
인터스텔라 주인공 이름이 뭐야?	findPerson
안시성 여주 이름	findPerson
겨울왕국 여자 주인공 누구지?	findPerson
라라랜드 연출자이름이 뭐지?	findPerson
해빙 남주 검색해	search
셔터 남자 주인공 알려줘	findPerson
겨울왕국 영화 감독 누구야?	findPerson
라라랜드 여자 주인공 찾아줘	findPerson
해빙 맡은 배우 이름이 뭐야?	findPerson
셔터 여주이름이 뭐지?	findPerson
인터스텔라 주인공 알려줘	findPerson
인피니티워 남자 주인공 누구야?	findPerson
안시성 연출자 찾아줘	findPerson
인터스텔라 영화 감독 검색해줘	search
엘사 나오는 영화 1차 예고편 재생	getTrailer
어벤저스 3 트레일러 알려줘	getTrailer
인피니티 워 프로모션 영상 찾아줘	getTrailer
셔터 유튜브 예고편 알고 싶어	getTrailer
안시성 극장 예고편 보여줘	getTrailer
겨울 왕국 예고편 검색해줘	search
인터스텔라 극장 예고편 찾아줘	getTrailer
해빙 예고편 알려줘	getTrailer
라라랜드 트레일러 검색해줘	search
엘사 나오는 영화 프로모션 영상 알고 싶어	getTrailer
겨울 왕국 1차 예고편 재생	getTrailer
안시성 유튜브 예고편 보여줘	getTrailer
해빙 유튜브 예고편 알려줘	getTrailer
어벤저스 3 1차 예고편 재생	getTrailer
인터스텔라 1차 예고편 알고 싶어	getTrailer
해빙 예고편 보여줘	getTrailer
인피니티 워 트레일러 찾아줘	getTrailer
겨울 왕국 프로모션 영상 검색해줘	search
인터스텔라 1차 예고편 재생	getTrailer
안시성 극장 예고편 알고 싶어	getTrailer
엘사 나오는 영화 유튜브 예고편 알려줘	getTrailer
어벤저스3 1차 예고편 보여줘	getTrailer
라라랜드 예고편 검색해줘	search
셔터 극장 예고편 알고 싶어	getTrailer
해빙 프로모션 영상 알려줘	getTrailer
셔터 트레일러 찾아줘	getTrailer
인피니티 워 유튜브 예고편 재생	getTrailer
겨울 왕국 극장 예고편 알려줘	getTrailer
어벤저스 3 예고편 보여줘	getTrailer
안시성 트레일러 알고 싶어	getTrailer
인피니티워 예고편 찾아줘	getTrailer
엘사 나오는 영화 프로모션 영상 재생	getTrailer
안시성 극장 예고편 알고싶어	getTrailer
인터스텔라 유투브 예고편 검색해줘	search
 트레일러 알려줘	getTrailer
해빙 1차 예고편 보여줘	getTrailer
겨울왕국 유투브 예고편 재생	getTrailer
라라랜드 1차 예고편 알려줘	getTrailer
셔터 트레일러 보여줘	getTrailer
해빙 예고편 알고싶어	getTrailer
안시성 프로모션 영상 검색해줘	search
라라랜드 극장 예고편 찾아줘	getTrailer
겨울왕국 극장 예고편 재생	getTrailer
인피니티워 1차 예고편 검색해줘	search
엘사 나오는 영화 유투브 예고편 찾아줘	getTrailer
라라랜드 예고편 재생	getTrailer
겨울 왕국 유튜브 예고편 알고 싶어	getTrailer
어벤저스 3 극장 예고편 찾아줘	getTrailer
해빙 트레일러 검색해줘	search
인피니티 워 프로모션 영상 보여줘	getTrailer
인터스텔라 1차 예고편 알려줘	getTrailer
엘사 나오는 영화 트레일러 알고 싶어	getTrailer
셔터 극장 예고편 보여줘	getTrailer
안시성 1차 예고편 검색해줘	search
라라랜드 예고편 재생	getTrailer
안시성 유튜브 예고편 찾아줘	getTrailer
엘사 나오는 영화 프로모션 영상 알려줘	getTrailer
어벤저스 3 유튜브 예고편 알고 싶어	getTrailer
셔터 1차 예고편 알려줘	getTrailer
해빙 예고편 검색해줘	search
엘사 나오는 영화 프로모션 영상 알려줘	getTrailer
라라랜드 극장 예고편 알고싶어	getTrailer
인피니티워 트레일러 보여줘	getTrailer
 유투브 예고편 찾아줘	getTrailer
겨울왕국 예고편 검색해줘	search
안시성 1차 예고편 재생	getTrailer
셔터 프로모션 영상 검색해줘	search
해빙 예고편 보여줘	getTrailer
인터스텔라 극장 예고편 알려줘	getTrailer
겨울왕국 유투브 예고편 재생	getTrailer
엘사 나오는 영화 1차 예고편 알고싶어	getTrailer
해빙 트레일러 찾아줘	getTrailer
안시성 1차 예고편 보여줘	getTrailer
인피니티워 예고편 재생	getTrailer
라라랜드 유투브 예고편 알고싶어	getTrailer
안시성 예고편 검색해줘	search
겨울왕국 트레일러 알고싶어	getTrailer
엘사 나오는 영화 프로모션 영상 재생	getTrailer
인피니티워 유투브 예고편 찾아줘	getTrailer
라라랜드 1차 예고편 알려줘	getTrailer
셔터 극장 예고편 보여줘	getTrailer
 1차 예고편 재생	getTrailer
해빙 프로모션 영상 알려줘	getTrailer
인터스텔라 예고편 알고싶어	getTrailer
인피니티워 극장 예고편 검색해줘	search
해빙 트레일러 찾아줘	getTrailer
겨울왕국 유투브 예고편 보여줘	getTrailer
라라랜드 트레일러 재생	getTrailer
셔터 프로모션 영상 보여줘	getTrailer
 프로모션 영상 검색해줘	search
인터스텔라 1차 예고편 알려줘	getTrailer
엘사 나오는 영화 프로모션 영상 재생	getTrailer
셔터 유투브 예고편 찾아줘	getTrailer
인피니티워 트레일러 검색해줘	search
라라랜드 예고편 보여줘	getTrailer
안시성 극장 예고편 알고싶어	getTrailer
해빙 1차 예고편 보여줘	getTrailer
겨울왕국 극장 예고편 재생	getTrailer
 트레일러 알려줘	getTrailer
안시성 프로모션 영상 알고싶어	getTrailer
인피니티워 예고편 검색해줘	search
인터스텔라 유투브 예고편 찾아줘	getTrailer
겨울왕국 극장 예고편 보여줘	getTrailer
엘사 나오는 영화 유투브 예고편 알려줘	getTrailer
셔터 1차 예고편 알고싶어	getTrailer
인터스텔라 유투브 예고편 알고싶어	getTrailer
겨울왕국 1차 예고편 알려줘	getTrailer
해빙 극장 예고편 찾아줘	getTrailer
라라랜드 예고편 검색해줘	search
인피니티워 프로모션 영상 보여줘	getTrailer
안시성 트레일러 재생	getTrailer
 극장 예고편 보여줘	getTrailer
셔터 1차 예고편 검색해줘	search
엘사 나오는 영화 프로모션 영상 찾아줘	getTrailer
해빙 예고편 알려줘	getTrailer
엘사 나오는 영화 유투브 예고편 재생	getTrailer
안시성 트레일러 알고싶어	getTrailer
인터스텔라 프로모션 영상 알려줘	getTrailer
인피니티워 프로모션 영상 검색해줘	search
겨울왕국 유투브 예고편 보여줘	getTrailer
인피니티워 극장 예고편 알려줘	getTrailer
엘사 나오는 영화 예고편 찾아줘	getTrailer
해빙 트레일러 보여줘	getTrailer
겨울왕국 프로모션 영상 알고싶어	getTrailer
인터스텔라 유투브 예고편 검색해줘	search
셔터 1차 예고편 재생	getTrailer
안시성 유투브 예고편 알려줘	getTrailer
 극장 예고편 검색해줘	search
라라랜드 트레일러 알고싶어	getTrailer
해빙 프로모션 영상 보여줘	getTrailer
인피니티워 1차 예고편 재생	getTrailer
엘사 나오는 영화 예고편 찾아줘	getTrailer
셔터 1차 예고편 재생	getTrailer
라라랜드 유투브 예고편 찾아줘	getTrailer
 극장 예고편 알고싶어	getTrailer
 유투브 예고편 알려줘	getTrailer
인피니티워 예고편 알고싶어	getTrailer
안시성 프로모션 영상 재생	getTrailer
엘사 나오는 영화 1차 예고편 찾아줘	getTrailer
라라랜드 트레일러 검색해줘	search
해빙 극장 예고편 보여줘	getTrailer
인터스텔라 1차 예고편 검색해줘	search
셔터 트레일러 찾아줘	getTrailer
겨울왕국 예고편 알려줘	getTrailer
셔터 유투브 예고편 재생	getTrailer
인피니티워 극장 예고편 알고싶어	getTrailer
인터스텔라 프로모션 영상 보여줘	getTrailer
라라랜드 예고편 찾아줘	getTrailer
겨울왕국 프로모션 영상 알고싶어	getTrailer
엘사 나오는 영화 트레일러 알고싶어	getTrailer
라라랜드 트레일러 찾아줘	getTrailer
겨울왕국 프로모션 영상 알려줘	getTrailer
해빙 예고편 알고싶어	getTrailer
인피니티워 1차 예고편 검색해줘	search
셔터 유투브 예고편 재생	getTrailer
인터스텔라 극장 예고편 보여줘	getTrailer
 프로모션 영상 재생	getTrailer
엘사 나오는 영화 유투브 예고편 보여줘	getTrailer
안시성 1차 예고편 알고싶어	getTrailer
 극장 예고편 알려줘	getTrailer
라라랜드 트레일러 검색해줘	search
안시성 예고편 찾아줘	getTrailer
인피니티워 프로모션 영상 알려줘	getTrailer
인터스텔라 예고편 재생	getTrailer
해빙 유투브 예고편 찾아줘	getTrailer
엘사 나오는 영화 트레일러 재생	getTrailer
인피니티워 예고편 보여줘	getTrailer
안시성 1차 예고편 찾아줘	getTrailer
셔터 극장 예고편 검색해줘	search
 유투브 예고편 알려줘	getTrailer
겨울왕국 프로모션 영상 알고싶어	getTrailer
인터스텔라 1차 예고편 재생	getTrailer
라라랜드 극장 예고편 알려줘	getTrailer
해빙 트레일러 알고싶어	getTrailer
셔터 예고편 찾아줘	getTrailer
안시성 프로모션 영상 검색해줘	search
라라랜드 유투브 예고편 보여줘	getTrailer
겨울왕국 프로모션 영상 보여줘	getTrailer
인터스텔라 극장 예고편 알고싶어	getTrailer
해빙 극장 예고편 알려줘	getTrailer
라라랜드 극장 포스터 알려줘	getPoster
해빙 홍보물 검색해줘	search
앤 해서웨이 나오는 우수영 화 알고 싶어	getPoster
엘사 나오는 영화 홍보 포스터 보여줘	getPoster
존 레전드 나오는 음악영화 포스터 찾아줘	getPoster
인터스텔라 홍보 포스터 알려줘	getPoster
안시성 극장 포스터 찾아줘	getPoster
얼음이 나오는 디즈니 영화 포스터 보여줘	getPoster
엠마 스톤 나오는 음악 영화 알고 싶어	getPoster
매튜 맥커너히 나오는 우주영화 홍보물 검색해줘	search
라이언 고슬링 엠마 스톤 나오는 영화 포스터 알고 싶어	getPoster
어벤저스 3 극장 포스터 보여줘	getPoster
인피니티 워 찾아줘	getPoster
겨울 왕국 홍보 포스터 검색해줘	search
조진웅 나오는 스릴러 홍보 포스터 찾아줘	getPoster
 극장포스터 검색해줘	search
조진웅 나오는 스릴러 포스터 찾아줘	getPoster
데이미언 셔젤 감독의 두번째 음약영화 홍보물 보여줘	getPoster
겨울왕국 알려줘	getPoster
인피니티워 홍보 포스터 알고싶어	getPoster
크리스토퍼 놀란 감독 우주영화 홍보 포스터 검색해줘	search
라라랜드 홍보물 알고싶어	getPoster
타노스 나오는 영화 포스터 찾아줘	getPoster
라이언 고슬링 엠마스톤 나오는 영화 극장포스터 보여줘	getPoster
엘사 나오는 영화 알려줘	getPoster
셔젤감독의 두번째 영화 검색해줘	search
존 레전드 나오는 음악영화 홍보 포스터 알고싶어	getPoster
해빙 극장포스터 찾아줘	getPoster
앤 해서웨이 나오는 우주영화 포스터 알고싶어	getPoster
엠마스톤 나오는 음악 영화 홍보물 알려줘	getPoster
겨울왕국 홍보 포스터 알려줘	getPoster
얼음이 나오는 디즈니영화 홍보물 검색해줘	search
라이언 고슬링 나오는 음악영화 극장포스터 보여줘	getPoster
엘사 나오는 영화 알고싶어	getPoster
조진웅 나오는 스릴러 포스터 찾아줘	getPoster
셔터 홍보 포스터 알고싶어	getPoster
타노스 나오는 영화 홍보물찾아줘	getPoster
존 레전드 나오는 음악영화 극장포스터 알려줘	getPoster
 검색해줘	search
루소형제 감독의 시빌워 다음영화 포스터 보여줘	getPoster
셔젤감독의 두번째 영화 포스터 보여줘	getPoster
앤 해서웨이 나오는 우주영화 극장포스터 찾아줘	getPoster
루소형제 감독의 MCU 영화 홍보물 알고싶어	getPoster
인터스텔라 알려줘	getPoster
안시성 포스터 알고싶어	getPoster
어벤저스 3 극장 포스터 알려줘	getPoster
조진웅 나오는 스릴러 홍보물 알고 싶어	getPoster
엘사 나오는 영화 검색해줘	search
엠마 스톤 나오는 음악 영화 포스터 찾아줘	getPoster
인터스텔라 홍보 포스터 보여줘	getPoster
겨울 왕국 홍보 포스터 알고 싶어	getPoster
루소 형제 감독의 시빌 워 다음 영화 포스터 검색해줘	search
앤 해서웨이 나오는 우주영화 보여줘	getPoster
루소 형제 감독의 MCU 영화 홍보물 찾아줘	getPoster
라이언 고슬링 나오는 음악영화 극장 포스터 알려줘	getPoster
존 레전드 나오는 음악영화 극장 포스터 알려줘	getPoster
타 노스 나오는 영화 검색해줘	search
셔젤 감독의 두 번째 영화 포스터 찾아줘	getPoster
얼음이 나오는 디즈니 영화 홍보 포스터 알려줘	getPoster
해빙 홍보 포스터 알고 싶어	getPoster
데이미언 셔젤 감독의 두번째 음약영화 홍보물 알려줘	getPoster
존 레전드 나오는 음악영화 극장포스터 검색해줘	search
인터스텔라 포스터 보여줘	getPoster
그 영화 포스터 좀 찾아줘	getPoster
안시성 홍보 포스터 찾아줘	getPoster
그 영화 포스터 좀 알려줘	getPoster
셔젤감독의 두번째 영화 홍보 포스터 알려줘	getPoster
앤 해서웨이 나오는 우주영화 홍보물 검색해줘	search
엠마스톤 나오는 음악 영화 포스터 보여줘	getPoster
매튜매커너히 나오는 우주영화 극장포스터 알고싶어	getPoster
얼음이 나오는 디즈니영화 극장포스터 찾아줘	getPoster
라이언 고슬링 엠마스톤 나오는 영화 알고싶어	getPoster
타노스 나오는 영화 홍보물 알려줘	getPoster
라이언 고슬링 나오는 음악영화 극장포스터 검색해줘	search
크리스토퍼 놀란 감독 우주영화 포스터 찾아줘	getPoster
조진웅 나오는 스릴러 홍보물찾아줘	getPoster
라이언 고슬링 엠마스톤 나오는 영화 홍보 포스터 알고싶어	getPoster
존 레전드 나오는 음악영화 극장포스터 보여줘	getPoster
루소형제 감독의 MCU 영화 포스터 알려줘	getPoster
타노스 나오는 영화 검색해줘	search
앤 해서웨이 나오는 우주영화 홍보물찾아줘	getPoster
매튜매커너히 나오는 우주영화 극장포스터 알고싶어	getPoster
라라랜드 홍보 포스터 보여줘	getPoster
그 영화 포스터 좀	getPoster
엘사 나오는 영화 포스터 알려줘	getPoster
겨울왕국 홍보물 검색해줘	search
안시성 포스터 찾아줘	getPoster
얼음이 나오는 디즈니영화 극장포스터 알려줘	getPoster
데이미언 셔젤 감독의 두번째 음약영화 포스터 보여줘	getPoster
영화 포스터 보여줘	getPoster
얼음이 나오는 디즈니영화 알고싶어	getPoster
엘사 나오는 영화 홍보 포스터 찾아줘	getPoster
셔젤감독의 두번째 영화 홍보물 알려줘	getPoster
인터스텔라 극장포스터 보여줘	getPoster
셔터 포스터 검색해줘	search
루소형제 감독의 MCU 영화 포스터 찾아줘	getPoster
겨울왕국 포스터 보여줘	getPoster
데이미언 셔젤 감독의 두번째 음약영화 홍보물 검색해줘	search
타노스 나오는 영화 홍보 포스터 보여줘	getPoster
앤 해서웨이 나오는 우주영화 극장포스터 알고싶어	getPoster
루소형제 감독의 시빌워 다음영화 포스터 알고싶어	getPoster
라이언 고슬링 엠마스톤 나오는 영화 포스터 검색해줘	search
안시성 극장포스터 검색해줘	search
라라랜드 홍보물 보여줘	getPoster
영화 포스터 좀	getPoster
라이언 고슬링 나오는 음악영화 홍보 포스터 검색해줘	search
얼음이 나오는 디즈니 영화 알려줘	getPoster
인피니티 워 극장 포스터 보여줘	getPoster
안시성 포스터 알고 싶어	getPoster
앤 해서웨이 나오는 우주영화 홍보물 찾아줘	getPoster
어벤저스 3 포스터 찾아줘	getPoster
크리스토퍼 놀런 감독 우주영화 홍보물 검색해줘	search
조진웅 나오는 스릴러 극장 포스터 보여줘	getPoster
셔젤 감독의 두 번째 영화 홍보 포스터 알려줘	getPoster
타 노스 나오는 영화 알고 싶어	getPoster
엘사 나오는 영화 극장 포스터 찾아줘	getPoster
루소 형제 감독의 시빌 워 다음 영화 포스터 알고 싶어	getPoster
인터스텔라 검색해줘	search
겨울 왕국 좀 검색해줘	search
해빙 홍보물 알고 싶어	getPoster
타노스 나오는 영화 포스터 찾아줘	getPoster
데이미언 셔젤 감독의 두번째 음약영화 극장포스터 알고싶어	getPoster
셔젤감독의 두번째 영화 검색해줘	search
루소형제 감독의 MCU 영화 홍보물 알려줘	getPoster
안시성 홍보 포스터 보여줘	getPoster
엘사 나오는 영화 포스터 보여줘	getPoster
라이언 고슬링 나오는 음악영화 홍보 포스터 알려줘	getPoster
엠마스톤 나오는 음악 영화 극장포스터 검색해줘	search
얼음이 나오는 디즈니영화 포스터 알고싶어	getPoster
포스터 찾아줘	getPoster
라이언 고슬링 엠마스톤 나오는 영화 포스터 보여줘	getPoster
존 레전드 나오는 음악영화 홍보 포스터 알고싶어	getPoster
루소형제 감독의 시빌워 다음영화 포스터 보여줘	getPoster
해빙 알고싶어	getPoster
겨울왕국 극장포스터 알려줘	getPoster
라이언 고슬링 나오는 음악영화 홍보 포스터 알고싶어	getPoster
인터스텔라 홍보물 검색해줘	search
안시성 극장포스터 찾아줘	getPoster
포스터 찾아줄래	getPoster
 포스터 보여줘	getPoster
앤 해서웨이 나오는 우주영화 포스터 검색해줘	search
엠마스톤 나오는 음악 영화 극장포스터 찾아줘	getPoster
인피니티워 검색해줘	search
루소형제 감독의 시빌워 다음영화 홍보물 알려줘	getPoster
엘사 나오는 영화 홍보 포스터 보여줘	getPoster
루소형제 감독의 MCU 영화 포스터 찾아줘	getPoster
라라랜드 인터넷에 검색해줘	search
존 레전드 나오는 음악영화 포스터 검색해줘	search
타노스 나오는 영화 홍보 포스터 보여줘	getPoster
크리스토퍼 놀란 감독 우주영화 보여줘	getPoster
루소형제 감독의 시빌워 다음영화 홍보 포스터 보여줘	getPoster
라라랜드 포스터 알고싶어	getPoster
엘사 나오는 영화 홍보물 알려줘	getPoster
매튜매커너히 나오는 우주영화 검색해줘	search
해빙 극장포스터 찾아줘	getPoster
존 레전드 나오는 음악영화 포스터 찾아줘	getPoster
 홍보 포스터 보여줘	getPoster
라이언 고슬링 나오는 음악영화 극장포스터 알고싶어	getPoster
영화 검색해줘	search
루소형제 감독의 MCU 영화 홍보물 검색해줘	search
앤 해서웨이 나오는 우주영화 홍보 포스터 보여줘	getPoster
타노스 나오는 영화 극장포스터 찾아줘	getPoster
겨울왕국 극장포스터 검색해줘	search
인피니티워 알려줘	getPoster
얼음이 나오는 디즈니영화 포스터 찾아줘	getPoster
엘사 나오는 영화 알려줘	getPoster
인터스텔라 포스터 알고싶어	getPoster
라이언 고슬링 엠마스톤 나오는 영화 홍보 포스터 검색해줘	search
안시성 홍보물찾아줘	getPoster
겨울왕국 극장포스터 보여줘	getPoster
인피니티워 극장포스터 찾아줘	getPoster
루소형제 감독의 시빌워 다음영화 홍보물 알려줘	getPoster
얼음이 나오는 디즈니영화 포스터 보여줘	getPoster
존 레전드 나오는 음악영화 홍보 포스터 검색해줘	search
앤 해서웨이 나오는 우주영화 알고싶어	getPoster
타노스 나오는 영화 홍보 포스터 검색해줘	search
라이언 고슬링 나오는 음악영화 홍보물찾아줘	getPoster
조진웅 나오는 스릴러 홍보물 알고싶어	getPoster
루소형제 감독의 MCU 영화 홍보 포스터 알고싶어	getPoster
엠마스톤 나오는 음악 영화 포스터 보여줘	getPoster
루소형제 감독의 MCU 영화 보여줘	getPoster
매튜매커너히 나오는 우주영화 홍보 포스터 알려줘	getPoster
루소형제 감독의 시빌워 다음영화 극장포스터 검색해줘	search
라이언 고슬링 나오는 음악영화 포스터 찾아줘	getPoster
영화 포스터 알고싶어	getPoster
겨울왕국 극장포스터 찾아줘	getPoster
셔젤감독의 두번째 영화 검색해서 알려줘	search
앤 해서웨이 나오는 우주영화 검색해줘	search
해빙 포스터 찾아줘	getPoster
인피니티워 홍보 포스터 검색해줘	search
얼음이 나오는 디즈니영화 홍보 포스터 알고싶어	getPoster
엠마스톤 나오는 음악 영화 찾아줘	search
조진웅 나오는 스릴러 홍보 포스터 찾아줘	getPoster
엘사 나오는 영화 극장포스터 검색해줘	search
라라랜드 포스터 보여줘	getPoster
라이언 고슬링 엠마스톤 나오는 영화 포스터 검색해줘	search
인터스텔라 찾아줘	search
얼음이 나오는 디즈니영화 홍보물찾아줘	getPoster
데이미언 셔젤 감독의 두번째 음약영화 홍보 포스터 알고싶어	getPoster
라라랜드 극장포스터 알려줘	getPoster
셔터 인터넷에서 찾아줘	search
해빙 홍보 포스터 찾아줘	getPoster
크리스토퍼 놀란 감독 우주영화 홍보물 보여줘	getPoster
앤 해서웨이 나오는 우주영화 극장포스터 검색해줘	search
엠마스톤 나오는 음악 영화 포스터 알려줘	getPoster
존 레전드 나오는 음악영화 홍보물찾아줘	getPoster
셔젤감독의 두번째 영화 홍보 포스터 검색해줘	search
안시성 검색해줘	search
매튜매커너히 나오는 우주영화 홍보물 알고싶어	getPoster
타노스 나오는 영화 홍보 포스터 보여줘	getPoster
존 레전드 나오는 음악영화 포스터 알고싶어	getPoster
셔터 극장포스터 보여줘	getPoster
엠마스톤 나오는 음악 영화 포스터 찾아줘	getPoster
조진웅 나오는 스릴러 알려줘	search
안시성 홍보 포스터 검색해줘	search
데이미언 셔젤 감독의 두번째 음약영화 알려줘	getPoster
크리스토퍼 놀란 감독 우주영화 포스터 보여줘	getPoster
포스터 알고싶어	getPoster
루소형제 감독의 시빌워 다음영화 극장포스터 검색해줘	search
인피니티워 홍보 포스터 찾아줘	getPoster
포스터 알려줘	getPoster
라이언 고슬링 나오는 음악영화 홍보물 알려줘	getPoster
라이언 고슬링 엠마스톤 나오는 영화 포스터 검색해줘	search
겨울왕국 홍보 포스터 찾아줘	getPoster
매튜매커너히 나오는 우주영화 알고싶어	search
인피니티워 극장포스터 알려줘	getPoster
존 레전드 나오는 음악영화 포스터 찾아줘	getPoster
홍보물 보여줘	getPoster
타노스 나오는 영화 홍보 포스터 알고싶어	getPoster
루소형제 감독의 시빌워 다음영화 검색해줘	search
데이미언 셔젤 감독의 두번째 음약영화 홍보 포스터 알고싶어	getPoster
크리스토퍼 놀란 감독 우주영화 극장포스터 검색해줘	search
엠마스톤 나오는 음악 영화 홍보물 보여줘	getPoster
영화 검색해줘	search
라라랜드 포스터 알려줘	getPoster
앤 해서웨이 나오는 우주영화 극장포스터 찾아줘	getPoster
매튜매커너히 나오는 우주영화 알려줘	getPoster
인터스텔라 극장포스터 알고싶어	getPoster
해빙 홍보 포스터 보여줘	getPoster
셔젤감독의 두번째 영화 홍보물 검색해줘	search
인피니티워 홍보 포스터 찾아줘	getPoster
안시성 포스터 보여줘	getPoster
데이미언 셔젤 감독의 두번째 음약영화 홍보물 알고싶어	getPoster
인터넷에서 영화 검색해줘	search
얼음이 나오는 디즈니영화 극장포스터 알려줘	getPoster
매튜매커너히 나오는 우주영화 홍보 포스터 찾아줘	getPoster
엠마스톤 나오는 음악 영화 알려줘	getPoster
타노스 나오는 영화 홍보물 알고싶어	getPoster
조진웅 나오는 스릴러 포스터 보여줘	getPoster
해빙 극장포스터 검색해줘	search
라라랜드 극장포스터 찾아줘	getPoster
존 레전드 나오는 음악영화 알려줘	getPoster
겨울왕국 홍보물 보여줘	getPoster
엘사 나오는 영화 포스터 알고싶어	getPoster
라이언 고슬링 나오는 음악영화 극장포스터 알려줘	getPoster
존 레전드 나오는 음악영화 알고싶어	getPoster
 홍보 포스터 검색해줘	search
엠마스톤 나오는 음악 영화 포스터 보여줘	getPoster
매튜매커너히 나오는 우주영화 극장포스터 찾아줘	getPoster
루소형제 감독의 MCU 영화 홍보물 알려줘	getPoster
인터스텔라 포스터 검색해줘	search
해빙 홍보 포스터 알려줘	getPoster
홍보 포스터 보여줘	getPoster
셔젤감독의 두번째 영화 보여줘	getPoster
라라랜드 극장포스터 알고싶어	getPoster
라이언 고슬링 나오는 음악영화 홍보 포스터 보여줘	getPoster
겨울왕국 극장포스터 검색해줘	search
앤 해서웨이 나오는 우주영화 알고싶어	getPoster
라이언 고슬링 엠마스톤 나오는 영화 포스터 찾아줘	getPoster
조진웅 나오는 스릴러 포스터 알려줘	getPoster
라라랜드는 어느 배급사에서 만들었어?	getMaker
루소 형제 감독의 MCU 영화는 어느 나라 영화야?	getMaker
존 레전드 나오는 음악영화는 어떤 나라 작품이야?	getMaker
셔젤 감독의 두 번째 영화는 어떤 배급사 에서 만들었어?	getMaker
엘사 나오는 영화는 어떤 나라 작품이야?	getMaker
라이언 고슬링 나오는 음악영화는 어느 배급사 에서 만들었어?	getMaker
조진웅 나오는 스릴러는 어느 나라 영화야?	getMaker
크리스토퍼 놀런 감독 우주영화는 어떤 배급사 영화?	getMaker
라이언 고슬링 엠마 스톤 나오는 영화는 어느 배급사 에서 만들었어?	getMaker
셔터는 어떤 나라에서 만들었어?	getMaker
인피니티 워는 어떤 나라 작품이야?	getMaker
만든 배급사 알려줘	getMaker
루소 형제 감독의 시빌 워 다음 영화는 어느 배급사 영화야?	getMaker
엠마 스톤 나오는 음악 영화는 어느 나라 영화?	getMaker
어벤저스 3은 어느 나라 작품이야?	getMaker
타노스 나오는 영화는 어떤 배급사 영화야?	getMaker
존 레전드 나오는 음악영화는 어떤 나라영화?	getMaker
인피니티워는 어느 배급사 에서 만들었어?	getMaker
라이언 고슬링 나오는 음악영화는 어느 나라영화야?	getMaker
매튜매커너히 나오는 우주영화는 어떤 배급사 작품이야?	getMaker
은 어느 배급사 영화야?	getMaker
라이언 고슬링 엠마스톤 나오는 영화는 어떤 배급사 작품이야?	getMaker
셔젤감독의 두번째 영화는 어느 나라에서 만들었어?	getMaker
엠마스톤 나오는 음악 영화는 어느 나라작품이야?	getMaker
안시성은 어떤 나라에서 만들었어?	getMaker
셔터는 어느 나라에서 만들었어?	getMaker
해빙은 어떤 나라영화야?	getMaker
엘사 나오는 영화는 어느 배급사 영화?	getMaker
겨울왕국은 어느 배급사 영화?	getMaker
타노스 나오는 영화는 어느 배급사에서 만들었어?	getMaker
데이미언 셔젤 감독의 두번째 음약영화는 어떤 나라영화?	getMaker
겨울왕국은 어떤 배급사 작품이야?	getMaker
안시성은 어느 나라에서 만들었어?	getMaker
루소형제 감독의 시빌워 다음영화는 어느 배급사 영화야?	getMaker
앤 해서웨이 나오는 우주영화는 어떤 배급사 영화?	getMaker
셔터는 어느 나라영화야?	getMaker
존 레전드 나오는 음악영화는 어떤 나라작품이야?	getMaker
크리스토퍼 놀란 감독 우주영화는 어느 배급사 에서 만들었어?	getMaker
셔젤감독의 두번째 영화는 어느 나라에서 만들었어?	getMaker
해빙은 배급사 알려줘	getMaker
타노스 나오는 영화는 어느 배급사 영화?	getMaker
라라랜드는 어떤 나라에서 만들었어?	getMaker
엠마스톤 나오는 음악 영화는 어떤 배급사 영화?	getMaker
라이언 고슬링 엠마스톤 나오는 영화는 어떤 나라작품이야?	getMaker
루소형제 감독의 MCU 영화는 어느 나라작품이야?	getMaker
셔터는 어디 배급사야?	getMaker
루소형제 감독의 시빌워 다음영화는 어느 배급사 영화야?	getMaker
앤 해서웨이 나오는 우주영화는 어떤 나라에서 만들었어?	getMaker
라라랜드는 어떤 배급사 영화야?	getMaker
데이미언 셔젤 감독의 두번째 음약영화는 어떤 나라영화?	getMaker
라이언 고슬링 나오는 음악영화는 어느 배급사 에서 만들었어?	getMaker
엘사 나오는 영화는 어떤 배급사 작품이야?	getMaker
셔젤감독의 두번째 영화는 어떤 배급사 에서 만들었어?	getMaker
안시성은 어느 배급사 작품이야?	getMaker
겨울왕국은 어느 나라영화?	getMaker
크리스토퍼 놀란 감독 우주영화는 어느 나라영화?	getMaker
존 레전드 나오는 음악영화는 어느 배급사 영화야?	getMaker
엠마스톤 나오는 음악 영화는 어떤 나라에서 만들었어?	getMaker
겨울왕국은 어떤 배급사 영화야?	getMaker
라이언 고슬링 엠마스톤 나오는 영화는 어느 배급사 작품이야?	getMaker
앤 해서웨이 나오는 우주영화는 어떤 나라에서 만들었어?	getMaker
은 어느 나라영화?	getMaker
타노스 나오는 영화는 어떤 나라영화야?	getMaker
인터스텔라는 어느 나라작품이야?	getMaker
셔젤감독의 두번째 영화는 어떤 배급사 영화?	getMaker
인피니티워는 어느 배급사 에서 만들었어?	getMaker
라라랜드는 만든 배급사 알려줘	getMaker
크리스토퍼 놀란 감독 우주영화는 어떤 배급사 영화야?	getMaker
라이언 고슬링 나오는 음악영화는 어느 나라영화?	getMaker
안시성은 어떤 나라에서 만들었어?	getMaker
조진웅 나오는 스릴러는 어느 나라영화?	getMaker
해빙 만든 배급사 알려줘	getMaker
크리스토퍼 놀런 감독 우주영화는 어느 나라 작품이야?	getMaker
데 이미 언 셔젤 감독의 두 번째 음약 영화는 어느 배급사 영화?	getMaker
루소 형제 감독의 MCU 영화는 어떤 배급사 영화야?	getMaker
엠마 스톤 나오는 음악 영화는 어떤 배급사 영화야?	getMaker
앤 해서웨이 나오는 우주영화는 어느 배급사 작품이야?	getMaker
타 노스 나오는 영화는 어떤 나라 영화?	getMaker
셔젤 감독의 두 번째 영화는 어느 나라에서 만들었어?	getMaker
매튜 맥커너히 나오는 우주영화는 어느 배급사 작품이야?	getMaker
인피니티 워는 어떤 배급사 에서 만들었어?	getMaker
엘사 나오는 영화는 어느 나라 작품이야?	getMaker
존 레전드 나오는 음악영화는 어떤 배급사 영화?	getMaker
조진웅 나오는 스릴러는 어느 나라에서 만들었어?	getMaker
어벤저스 3은 어떤 나라 영화야?	getMaker
안시성은 어느 배급사 에서 만들었어?	getMaker
은 어떤 나라작품이야?	getMaker
셔젤감독의 두번째 영화는 어느 나라영화야?	getMaker
타노스 나오는 영화는 어떤 배급사 영화?	getMaker
인피니티워는 어느 배급사 에서 만들었어?	getMaker
존 레전드 나오는 음악영화는 어떤 배급사 영화?	getMaker
인터스텔라 만든 배급사 좀	getMaker
엠마스톤 나오는 음악 영화는 어느 배급사 에서 만들었어?	getMaker
앤 해서웨이 나오는 우주영화는 어느 배급사 영화?	getMaker
매튜매커너히 나오는 우주영화는 어떤 나라에서 만들었어?	getMaker
데이미언 셔젤 감독의 두번째 음약영화는 어떤 나라영화야?	getMaker
라이언 고슬링 나오는 음악영화는 어느 나라작품이야?	getMaker
크리스토퍼 놀란 감독 우주영화는 어떤 배급사 영화야?	getMaker
조진웅 나오는 스릴러는 어느 배급사 작품이야?	getMaker
해빙은 어느 배급사 영화야	getMaker
데이미언 셔젤 감독의 두번째 음약영화는 어느 배급사 영화야?	getMaker
인피니티워는 어떤 나라작품이야?	getMaker
엠마스톤 나오는 음악 영화는 어느 나라영화?	getMaker
존 레전드 나오는 음악영화는 어떤 배급사 에서 만들었어?	getMaker
인터스텔라는 어느 배급사 영화니	getMaker
크리스토퍼 놀란 감독 우주영화는 어떤 나라에서 만들었어?	getMaker
앤 해서웨이 나오는 우주영화는 어떤 배급사 작품이야?	getMaker
루소형제 감독의 MCU 영화는 어느 배급사 영화?	getMaker
타노스 나오는 영화는 어떤 배급사 작품이야?	getMaker
조진웅 나오는 스릴러는 어떤 나라영화?	getMaker
겨울왕국은 어떤 배급사 작품이야?	getMaker
어디 배급사 영화야	getMaker
엘사 나오는 영화는 어느 배급사 영화?	getMaker
해빙은 어느 배급사 에서 만들었어?	getMaker
안시성 만든 배급사 알려줘	getMaker
엘사 나오는 영화는 어떤 나라작품이야?	getMaker
루소형제 감독의 MCU 영화는 어느 배급사 영화?	getMaker
앤 해서웨이 나오는 우주영화는 어느 나라영화야?	getMaker
라라랜드는 어느 나라에서 만들었어?	getMaker
라이언 고슬링 나오는 음악영화는 어느 배급사 영화?	getMaker
크리스토퍼 놀란 감독 우주영화는 어떤 배급사 영화야?	getMaker
조진웅 나오는 스릴러는 어떤 나라작품이야?	getMaker
인터스텔라는 어느 나라작품이야?	getMaker
타노스 나오는 영화는 어떤 배급사 영화?	getMaker
안시성은 어떤 나라영화야?	getMaker
해빙은 어느 배급사 영화야	getMaker
존 레전드 나오는 음악영화는 어느 배급사 작품이야?	getMaker
매튜매커너히 나오는 우주영화는 어떤 나라에서 만들었어?	getMaker
셔젤감독의 두번째 영화는 어떤 배급사 에서 만들었어?	getMaker
매튜 맥커너히 나오는 우주영화는 어떤 배급사 영화?	getMaker
안시성은 어느 나라 작품이야?	getMaker
존 레전드 나오는 음악영화는 어떤 나라에서 만들었어?	getMaker
조진웅 나오는 스릴러는 어떤 나라 영화야?	getMaker
루소 형제 감독의 MCU 영화는 어떤 배급사 영화?	getMaker
셔젤 감독의 두 번째 영화는 어느 나라에서 만들었어?	getMaker
크리스토퍼 놀런 감독 우주영화는 어느 배급사 작품이야?	getMaker
라이언 고슬링 엠마 스톤 나오는 영화는 어떤 배급사 영화?	getMaker
어벤저스 3은 어떤 나라 영화?	getMaker
타 노스 나오는 영화는 어떤 나라에서 만들었어?	getMaker
해빙은 어떤 배급사 영화야?	getMaker
겨울 왕국은 어느 배급사 작품이야?	getMaker
데 이미 언 셔젤 감독의 두 번째 음약 영화는 어느 나라 작품이야?	getMaker
인터스텔라는 어느 나라에서 만들었어?	getMaker
인피니티워는 어느 배급사 영화?	getMaker
엠마스톤 나오는 음악 영화는 어느 나라영화야?	getMaker
매튜매커너히 나오는 우주영화는 어떤 배급사 에서 만들었어?	getMaker
타노스 나오는 영화는 어떤 나라작품이야?	getMaker
라이언 고슬링 엠마스톤 나오는 영화는 어느 나라영화야?	getMaker
셔젤감독의 두번째 영화는 어떤 배급사 작품이야?	getMaker
은 어떤 나라영화?	getMaker
인터스텔라는 어느 배급사 에서 만들었어?	getMaker
크리스토퍼 놀란 감독 우주영화는 어느 나라작품이야?	getMaker
존 레전드 나오는 음악영화는 어느 배급사 영화야?	getMaker
라라랜드는 어떤 나라영화?	getMaker
엘사 나오는 영화는 어떤 배급사 영화야?	getMaker
조진웅 나오는 스릴러는 어떤 나라에서 만들었어?	getMaker
셔터는 어느 배급사 작품이야?	getMaker
엘사 나오는 영화는 어떤 나라영화야?	getMaker
인피니티워는 어느 배급사 에서 만들었어?	getMaker
겨울왕국은 어느 나라영화?	getMaker
매튜매커너히 나오는 우주영화는 어떤 배급사 작품이야?	getMaker
해빙은 어떤 배급사 영화야?	getMaker
안시성은 어떤 나라에서 만들었어?	getMaker
데이미언 셔젤 감독의 두번째 음약영화는 어느 나라영화?	getMaker
앤 해서웨이 나오는 우주영화는 어느 배급사 작품이야?	getMaker
엠마스톤 나오는 음악 영화는 어느 배급사 영화?	getMaker
타노스 나오는 영화는 어떤 배급사 작품이야?	getMaker
루소형제 감독의 시빌워 다음영화는 어느 배급사 영화?	getMaker
셔터는 어떤 나라작품이야?	getMaker
크리스토퍼 놀란 감독 우주영화는 어느 나라에서 만들었어?	getMaker
라이언 고슬링 엠마스톤 나오는 영화는 어떤 나라에서 만들었어?	getMaker
존 레전드 나오는 음악영화는 어느 나라영화야?	getMaker
인피니티워는 어느 배급사 영화야?	getMaker
루소형제 감독의 MCU 영화는 어느 나라작품이야?	getMaker
라이언 고슬링 엠마스톤 나오는 영화는 어떤 배급사 영화?	getMaker
매튜매커너히 나오는 우주영화는 어떤 나라에서 만들었어?	getMaker
라이언 고슬링 나오는 음악영화는 어느 배급사 영화야?	getMaker
셔터는 어디 배급사 영화야	getMaker
라라랜드는 어떤 배급사 에서 만들었어?	getMaker
인터스텔라는 어떤 나라작품이야?	getMaker
엘사 나오는 영화는 어떤 배급사 영화야?	getMaker
데이미언 셔젤 감독의 두번째 음약영화는 어느 배급사 에서 만들었어?	getMaker
앤 해서웨이 나오는 우주영화는 어느 배급사 작품이야?	getMaker
엠마스톤 나오는 음악 영화는 어느 나라영화?	getMaker
해빙은 어떤 나라에서 만들었어?	getMaker
타노스 나오는 영화는 어느 나라영화야?	getMaker
은 어떤 배급사 영화야?	getMaker
셔젤감독의 두번째 영화는 어느 배급사 영화?	getMaker
인터스텔라는 어느 나라에서 만들었어?	getMaker
엠마스톤 나오는 음악 영화는 어떤 나라작품이야?	getMaker
루소형제 감독의 시빌워 다음영화는 어떤 나라영화야?	getMaker
라라랜드는 어디 나라작품이야?	getMaker
조진웅 나오는 스릴러는 어떤 배급사 에서 만들었어?	getMaker
겨울왕국은 어디 배급사 영화?	getMaker
인피니티워는 어느 배급사 작품이야?	getMaker
라이언 고슬링 나오는 음악영화는 어떤 나라영화?	getMaker
안시성은 어느 나라영화?	getMaker
라이언 고슬링 엠마스톤 나오는 영화는 어느 배급사 에서 만들었어?	getMaker
크리스토퍼 놀란 감독 우주영화는 어떤 배급사 영화야?	getMaker
앤 해서웨이 나오는 우주영화는 어떤 나라작품이야?	getMaker
셔터는 어떤 배급사 영화야?	getMaker
안시성은 어떤 제작사 영화야?	getMaker
어벤저스 3은 어디 제작사 영화?	getMaker
은 어디 제작사 에서 만들었어?	getMaker
인터스텔라는 어디 제작사 작품이야?	getMaker
라라랜드는 어디 제작사 영화?	getMaker
인피니티 워는 어디 제작사 작품이야?	getMaker
타 노스 나오는 영화는 어디 제작사 에서 만들었어?	getMaker
조진웅 나오는 스릴러는 어디 제작사 영화야?	getMaker
셔터는 어디 제작사 영화야?	getMaker
엘사 나오는 영화는 어디 제작사 영화?	getMaker
겨울 왕국은 어디 제작사 에서 만들었어?	getMaker
해빙은 어디 제작사 작품이야?	getMaker
인피니티 워는 어디 제작사 작품이야?	getMaker
라라랜드는 어디 제작사 영화?	getMaker
엘사 나오는 영화는 어디 제작사 에서 만들었어?	getMaker
은 어디 제작사 영화야?	getMaker
겨울왕국은 어디 제작사 에서 만들었어?	getMaker
조진웅 나오는 스릴러는 어디 제작사 작품이야?	getMaker
인터스텔라는 어디 제작사 영화?	getMaker
안시성은 어디 제작사 에서 만들었어?	getMaker
셔터는 어디 제작사 작품이야?	getMaker
타노스 나오는 영화는 어디 제작사 영화야?	getMaker
인피니티워는 어디 제작사 영화?	getMaker
엘사 나오는 영화는 어디 제작사 에서 만들었어?	getMaker
은 어떤 제작사 작품이야?	getMaker
해빙은 어디 제작사 영화야?	getMaker
라라랜드는 어디 제작사 에서 만들었어?	getMaker
인터스텔라는 어디 제작사 영화?	getMaker
엘사 나오는 영화는 어디 제작사 영화야?	getMaker
는 어디 제작사 작품이야?	getMaker
조진웅 나오는 스릴러는 어디 제작사 영화?	getMaker
라라랜드는 어디 제작사 에서 만들었어?	getMaker
타 노스 나오는 영화는 어디 제작사 영화야?	getMaker
인터스텔라는 어디 제작사 작품이야?	getMaker
인피니티 워는 어디 제작사 영화?	getMaker
어벤저스 3은 어디 제작사 영화야?	getMaker
은 어디 제작사 에서 만들었어?	getMaker
겨울 왕국은 어디 제작사 작품이야?	getMaker
셔터는 어디 제작사 에서 만들었어?	getMaker
해빙은 어디 제작사 영화?	getMaker
안시성은 어디 제작사 작품이야?	getMaker
엘사 나오는 영화는 어디 제작사 에서 만들었어?	getMaker
안시성은 어디 제작사 영화야?	getMaker
타 노스 나오는 영화는 어디 제작사 작품이야?	getMaker
셔터는 어디 제작사 영화야?	getMaker
셔터는 어디 제작사 작품이야?	getMaker
안시성은 어디 제작사 영화야?	getMaker
타노스 나오는 영화는 어디 제작사 영화?	getMaker
인피니티워는 어디 제작사 에서 만들었어?	getMaker
인터스텔라는 어디 제작사 에서 만들었어?	getMaker
라라랜드는 어디 제작사 작품이야?	getMaker
은 어디 제작사 영화야?	getMaker
엘사 나오는 영화는 어디 제작사 영화?	getMaker
해빙은 어디 제작사 작품이야?	getMaker
겨울왕국은 어디 제작사 에서 만들었어?	getMaker
조진웅 나오는 스릴러는 어디 제작사 작품이야?	getMaker
은 어디 제작사 영화?	getMaker
엘사 나오는 영화는 어디 제작사 영화?	getMaker
안시성은 어디 제작사 영화야?	getMaker
은 어디 제작사 에서 만들었어?	getMaker
겨울왕국은 어디 제작사 에서 만들었어?	getMaker
셔터는 어디 제작사 작품이야?	getMaker
인터스텔라는 어디 제작사 영화?	getMaker
엘사 나오는 영화는 어디 제작사 영화야?	getMaker
안시성은 어디 제작사 영화?	getMaker
은 어디 제작사 에서 만들었어?	getMaker
해빙은 어디 제작사 작품이야?	getMaker
라라랜드는 어디 제작사 영화야?	getMaker
은 어디 제작사 작품이야?	getMaker
타노스 나오는 영화는 어디 제작사 영화?	getMaker
조진웅 나오는 스릴러는 어디 제작사 영화야?	getMaker
인피니티워는 어디 제작사 에서 만들었어?	getMaker
인피니티워는 어디 제작사 영화?	getMaker
엘사 나오는 영화는 어디 제작사 영화야?	getMaker
셔터는 어디 제작사 에서 만들었어?	getMaker
조진웅 나오는 스릴러는 어디 제작사 영화야?	getMaker
타노스 나오는 영화는 어디 제작사 에서 만들었어?	getMaker
겨울왕국은 어디 제작사 영화?	getMaker
안시성은 어디 제작사 작품이야?	getMaker
인피니티워는 어디 제작사 영화?	getMaker
인터스텔라는 어디 제작사 영화야?	getMaker
은 어디 제작사 에서 만들었어?	getMaker
은 어디 제작사 작품이야?	getMaker
엘사 나오는 영화는 어디 제작사 작품이야?	getMaker
셔터는 어디 제작사 영화야?	getMaker
해빙은 어디 제작사 에서 만들었어?	getMaker
라라랜드는 어디 제작사 작품이야?	getMaker
인터스텔라는 어디 제작사 영화?	getMaker
은 어디 제작사 영화?	getMaker
타노스 나오는 영화는 어디 제작사 영화야?	getMaker
은 어디 제작사 영화야?	getMaker
은 어디 제작사 에서 만들었어?	getMaker
겨울왕국은 어디 제작사 작품이야?	getMaker
해빙은 어디 제작사 영화?	getMaker
셔터는 어디 제작사 영화야?	getMaker
인피니티워는 어디 제작사 영화?	getMaker
타노스 나오는 영화는 어디 제작사 작품이야?	getMaker
엘사 나오는 영화는 어디 제작사 에서 만들었어?	getMaker
라라랜드는 어디 제작사 영화야?	getMaker
안시성은 어디 제작사 작품이야?	getMaker
조진웅 나오는 스릴러는 어디 제작사 영화야?	getMaker
인터스텔라는 어디 제작사 에서 만들었어?	getMaker
타노스 나오는 영화는 어디 제작사 영화?	getMaker
해빙은 어디 제작사 에서 만들었어?	getMaker
겨울왕국은 어디 제작사 작품이야?	getMaker
라라랜드는 어디 제작사 에서 만들었어?	getMaker
조진웅 나오는 스릴러는 어디 제작사 영화야?	getMaker
안시성은 어디 제작사 작품이야?	getMaker
타노스 나오는 영화는 어디 제작사 영화?	getMaker
엘사 나오는 영화는 어디 제작사 영화야?	getMaker
셔터는 어디 제작사 작품이야?	getMaker
은 어디 제작사 영화?	getMaker
겨울왕국은 어디 제작사 에서 만들었어?	getMaker
은 어디 제작사 작품이야?	getMaker
해빙은 어디 제작사 에서 만들었어?	getMaker
인터스텔라는 어디 제작사 작품이야?	getMaker
인피니티워는 어디 제작사 에서 만들었어?	getMaker
겨울왕국은 어디 제작사 영화야?	getMaker
은 어디 제작사 영화?	getMaker
라라랜드는 어디 제작사 영화?	getMaker
라라랜드는 어디 제작사 작품이야?	getMaker
인터스텔라는 어디 제작사 영화야?	getMaker
셔터는 어디 제작사 영화?	getMaker
타노스 나오는 영화는 어디 제작사 에서 만들었어?	getMaker
조진웅 나오는 스릴러는 어디 제작사 영화야?	getMaker
은 어디 제작사 작품이야?	getMaker
해빙은 어디 제작사 에서 만들었어?	getMaker
엘사 나오는 영화는 어디 제작사 영화?	getMaker
안시성은 어디 제작사 영화?	getMaker
은 어디 제작사 작품이야?	getMaker
겨울왕국은 어디 제작사 영화야?	getMaker
인피니티워는 어디 제작사 영화야?	getMaker
해빙은 어디 제작사 작품이야?	getMaker
은 어디 제작사 영화?	getMaker
엘사 나오는 영화는 어디 제작사 에서 만들었어?	getMaker
조진웅 나오는 스릴러는 어디 제작사 영화야?	getMaker
해빙은 어디 제작사 에서 만들었어?	getMaker
타노스 나오는 영화는 어디 제작사 작품이야?	getMaker
셔터는 어디 제작사 영화?	getMaker
은 어디 제작사 영화?	getMaker
인피니티워는 어디 제작사 에서 만들었어?	getMaker
엘사 나오는 영화는 어디 제작사 작품이야?	getMaker
겨울왕국은 어디 제작사 영화야?	getMaker
은 어디 제작사 영화?	getMaker
안시성은 어디 제작사 에서 만들었어?	getMaker
라라랜드는 어디 제작사 영화야?	getMaker
인터스텔라는 어디 제작사 영화?	getMaker
해빙은 어디 제작사 작품이야?	getMaker
인터스텔라는 어디 제작사 에서 만들었어?	getMaker
겨울왕국은 어디 제작사 영화야?	getMaker
안시성은 어디 제작사 영화?	getMaker
엘사 나오는 영화는 어디 제작사 에서 만들었어?	getMaker
은 어디 제작사 영화야?	getMaker
인피니티워는 어디 제작사 작품이야?	getMaker
셔터는 어디 제작사 영화?	getMaker
인터스텔라는 어디 제작사 작품이야?	getMaker
해빙은 어디 제작사 영화야?	getMaker
타노스 나오는 영화는 어디 제작사 에서 만들었어?	getMaker
은 어디 제작사 에서 만들었어?	getMaker
겨울왕국은 어디 제작사 영화?	getMaker
조진웅 나오는 스릴러는 어디 제작사 영화야?	getMaker
라라랜드는 어디 제작사 작품이야?	getMaker
타노스 나오는 영화는 어디 제작사 영화?	getMaker
해빙은 어디 제작사 에서 만들었어?	getMaker
라라랜드는 어디 제작사 작품이야?	getMaker
인터스텔라는 어디 제작사 영화야?	getMaker
은 어디 제작사 에서 만들었어?	getMaker
라라랜드는 어디 제작사 작품이야?	getMaker
해빙은 어디 제작사 영화?	getMaker
타노스 나오는 영화는 어디 제작사 영화야?	getMaker
셔터는 어디 제작사 에서 만들었어?	getMaker
은 어디 제작사 영화?	getMaker
조진웅 나오는 스릴러는 어디 제작사 작품이야?	getMaker
인피니티워는 어디 제작사 영화?	getMaker
엘사 나오는 영화는 어디 제작사 영화야?	getMaker
안시성은 어디 제작사 작품이야?	getMaker
겨울왕국은 어디 제작사 영화야?	getMaker
겨울왕국은 어디 제작사 에서 만들었어?	getMaker
엘사 나오는 영화는 어디 제작사 작품이야?	getMaker
은 어디 제작사 영화?	getMaker
안시성  스토리 알려줘	getPlot
라라랜드  시놉시스  알아?	getPlot
겨울 왕국  간략한 내용  좀 정리해줄래?	getPlot
인터스텔라  줄거리  얘기해줘	getPlot
인피니티 워  스토리  요약해줘	getPlot
어벤저스 3 줄거리  요약해줘	getPlot
해빙  간략한 내용  정리해줘	getPlot
셔터  시놉시스 알려줘	getPlot
인피니티 워  줄거리  얘기해줘	getPlot
해빙  시놉시스 알고있니?	getPlot
어벤저스 3 줄거리  알아?	getPlot
라라랜드  간략한 내용  말해줄래?	getPlot
인터스텔라  스토리 알고 있어?	getPlot
셔터  간략한 내용 알려줘	getPlot
안시성  시놉시스  정리해줘	getPlot
 스토리 정리해줘	getPlot
인터스텔라 시놉시스 얘기해줄래?	getPlot
해빙 간략한 내용 알아?	getPlot
셔터 줄거리 요약해줘	getPlot
인피니티워 줄거리 알려줘	getPlot
겨울왕국 스토리아니?	getPlot
안시성 간략한 내용 요약해줄래?	getPlot
라라랜드 시놉시스알려줘	getPlot
해빙 시놉시스 정리해줘	getPlot
인피니티워 시놉시스 얘기해줘	getPlot
인터스텔라 스토리알려줘	getPlot
안시성 간략한 내용 얘기해줘	getPlot
라라랜드 줄거리 알아?	getPlot
 스토리 얘기해줘	getPlot
셔터 간략한 내용 알아?	getPlot
라라랜드 스토리 말해줘	getPlot
셔터 간략한 내용 요약해줘	getPlot
 줄거리 알아?	getPlot
해빙 시놉시스 정리해줘	getPlot
겨울왕국 간략한 내용 알려줘	getPlot
인터스텔라 시놉시스 알아?	getPlot
안시성 스토리 정리해줘	getPlot
인피니티워 줄거리 요약해줘	getPlot
인피니티워 줄거리 알려줘	getPlot
셔터 간략한 내용 알려줘	getPlot
해빙 줄거리 알아?	getPlot
겨울왕국 스토리 얘기해줘	getPlot
인터스텔라 간략한 내용 얘기해줘	getPlot
안시성 시놉시스 요약해줄래	getPlot
라라랜드 시놉시스 요약해줄래	getPlot
안시성  줄거리 알려줘	getPlot
셔터  시놉시스  알아?	getPlot
인피니티 워  간략한 내용  정리해줘	getPlot
인터스텔라  스토리  요약해줘	getPlot
겨울 왕국  스토리  얘기해줘	getPlot
라라랜드  줄거리  얘기해줘	getPlot
어벤저스 3 시놉시스  정리해줘	getPlot
해빙  간략한 내용 알려줘	getPlot
라라랜드  줄거리  알아?	getPlot
어벤저스 3 시놉시스  요약해줘	getPlot
셔터  간략한 내용  정리해줄래	getPlot
겨울 왕국  간략한 내용 요약해줘	getPlot
인터스텔라  스토리  알아?	getPlot
해빙  스토리  얘기해줘	getPlot
안시성  시놉시스 알려줘	getPlot
해빙 시놉시스 알아?	getPlot
인터스텔라 줄거리 요약해줘	getPlot
셔터 간략한 내용 얘기해줘	getPlot
겨울왕국 스토리알려줘	getPlot
인피니티워 시놉시스 정리해줘	getPlot
 줄거리 알아?	getPlot
라라랜드 간략한 내용 알려줘	getPlot
안시성 스토리 정리해줘	getPlot
겨울왕국 스토리 요약해줘	getPlot
인터스텔라 줄거리 얘기해줘	getPlot
해빙 간략한 내용 얘기해줘	getPlot
라라랜드 간략한 내용 알려줄래	getPlot
인피니티워 스토리 알아?	getPlot
안시성 줄거리 얘기해줘	getPlot
 시놉시스알려줘	getPlot
겨울왕국 스토리알려줘	getPlot
라라랜드 시놉시스 얘기해줘	getPlot
안시성 줄거리 정리해줘	getPlot
셔터 간략한 내용 요약해줘	getPlot
해빙 스토리 알아?	getPlot
인피니티워 시놉시스 알고있니	getPlot
 간략한 내용 요약해줘	getPlot
인터스텔라 줄거리 알아?	getPlot
안시성 줄거리 정리해줘	getPlot
해빙 스토리 얘기해줘	getPlot
겨울왕국 시놉시스 얘기해줘	getPlot
인피니티워 간략한 내용 요약해줘	getPlot
라라랜드 간략한 내용 정리해줘	getPlot
셔터 시놉시스 알아?	getPlot
인터스텔라 줄거리 알려줘	getPlot
안시성 간략한 내용 아니?	getPlot
인터스텔라 줄거리 정리해줘	getPlot
 시놉시스 얘기해줘	getPlot
셔터 스토리알려줘	getPlot
겨울왕국 간략한 내용 요약해줘	getPlot
인피니티워 스토리 알아?	getPlot
라라랜드 시놉시스 얘기해줘	getPlot
해빙 줄거리 알려줘	getPlot
라라랜드 스토리 요약해줘	getPlot
인피니티워 간략한 내용 정리 좀	getPlot
해빙 시놉시스 알아?	getPlot
인터스텔라 간략한 내용 얘기해줘	getPlot
안시성 줄거리 얘기해줘	getPlot
셔터 줄거리 알려줘	getPlot
 스토리 정리 좀	getPlot
셔터 간략한 내용 알아?	getPlot
인피니티워 시놉시스 얘기해줘	getPlot
라라랜드 줄거리 알려줘	getPlot
해빙 스토리 요약해줘	getPlot
 스토리 정리해줘	getPlot
겨울왕국 간략한 내용 정리해줘	getPlot
인터스텔라 시놉시스 요약 좀	getPlot
안시성 줄거리 알아?	getPlot
겨울왕국 간략한 내용 알려줘	getPlot
셔터 간략한 내용 얘기해줘	getPlot
안시성 시놉시스 요약해줘	getPlot
 줄거리 정리해줘	getPlot
인피니티워 줄거리 요약해줘	getPlot
인터스텔라 시놉시스 얘기해줘	getPlot
해빙 스토리 알아?	getPlot
겨울왕국 스토리 얘기해줘	getPlot
인터스텔라 시놉시스 알려줘	getPlot
안시성 줄거리 알아?	getPlot
인피니티워 간략한 내용 정리해줘	getPlot
셔터 시놉시스 요약해줘	getPlot
해빙 간략한 내용 얘기해줘	getPlot
라라랜드 스토리 요약해줘	getPlot
 줄거리 알려줘	getPlot
안시성 스토리 정리해줘	getPlot
인터스텔라 줄거리 알아?	getPlot
겨울왕국 시놉시스 알아?	getPlot
셔터 스토리 얘기해줘	getPlot
해빙 줄거리 알아?	getPlot
라라랜드 시놉시스 정리해줘	getPlot
 간략한 내용 요약해줘	getPlot
 스토리 정리해줘	getPlot
안시성 줄거리 알아?	getPlot
인피니티워 간략한 내용 알려줘	getPlot
인터스텔라 시놉시스 얘기해줘	getPlot
해빙 간략한 내용 요약해줘	getPlot
셔터 시놉시스 요약해줘	getPlot
겨울왕국 스토리 얘기해줘	getPlot
라라랜드 줄거리 알려줘	getPlot
셔터 간략한 내용 정리해줘	getPlot
해빙 시놉시스 알아?	getPlot
인터스텔라 줄거리 알려줘	getPlot
라라랜드 스토리알려줘	getPlot
인피니티워 간략한 내용 알아?	getPlot
안시성 줄거리 얘기해줘	getPlot
 시놉시스 요약해줘	getPlot
겨울왕국 줄거리 알려줘	getPlot
인터스텔라 간략한 내용 알아?	getPlot
해빙 시놉시스 요약해줘	getPlot
인피니티워 스토리 정리해줘	getPlot
라라랜드 간략한 내용 얘기해줘	getPlot
 시놉시스 정리해줘	getPlot
안시성 줄거리 알려줘	getPlot
셔터 스토리 얘기해줘	getPlot
 시놉시스 알아?	getPlot
겨울왕국 간략한 내용 요약해줘	getPlot
셔터 시놉시스 요약해줘	getPlot
라라랜드 줄거리 요약해줘	getPlot
안시성 스토리 알아?	getPlot
해빙 간략한 내용 얘기해줘	getPlot
인터스텔라 줄거리 정리해줘	getPlot
인터스텔라  간략한 내용  정리해줘	getPlot
겨울 왕국  줄거리  요약해줘	getPlot
안시성  스토리  알아?	getPlot
라라랜드  시놉시스  얘기해줘	getPlot
인피니티 워  줄거리 알려줘	getPlot
해빙  시놉시스  알아?	getPlot
셔터  스토리 알려줘	getPlot
어벤저스 3 간략한 내용  얘기해줘	getPlot
어벤저스 3 줄거리  정리해줘	getPlot
겨울 왕국  줄거리  요약해줘	getPlot
해빙  스토리  요약해줘	getPlot
인피니티 워  시놉시스 알려줘	getPlot
라라랜드  스토리  정리해줘	getPlot
셔터  간략한 내용  얘기해줘	getPlot
인터스텔라  시놉시스  알아?	getPlot
겨울왕국 시놉시스 요약해줘	getPlot
인피니티워 스토리알려줘	getPlot
라라랜드 간략한 내용 알아?	getPlot
인터스텔라 줄거리 정리해줘	getPlot
안시성 스토리 얘기해줘	getPlot
 간략한 내용 얘기해줘	getPlot
셔터 시놉시스 알아?	getPlot
해빙 줄거리 정리해줘	getPlot
안시성 간략한 내용 요약해줘	getPlot
해빙 간략한 내용 알려줘	getPlot
인터스텔라 시놉시스알려줘	getPlot
 스토리 정리해줘	getPlot
셔터 시놉시스 알아?	getPlot
라라랜드 줄거리 요약해줘	getPlot
겨울왕국 줄거리 요약해줘	getPlot
겨울왕국 줄거리 정리해줘	getPlot
셔터 시놉시스 요약해줘	getPlot
해빙 스토리알려줘	getPlot
안시성 간략한 내용 얘기해줘	getPlot
 스토리 알아?	getPlot
인피니티워 줄거리 알려줘	getPlot
라라랜드 시놉시스 요약해줘	getPlot
인터스텔라 간략한 내용 알아?	getPlot
겨울왕국 스토리 얘기해줘	getPlot
라라랜드 간략한 내용 정리해줘	getPlot
인피니티워 시놉시스 요약해줘	getPlot
안시성 스토리 얘기해줘	getPlot
인터스텔라 시놉시스 정리해줘	getPlot
셔터 줄거리 알려줘	getPlot
해빙 줄거리 정리해줘	getPlot
인터스텔라 간략한 내용 알려줘	getPlot
라라랜드 시놉시스 알아?	getPlot
 줄거리 정리해줘	getPlot
인피니티워 스토리 얘기해줘	getPlot
겨울왕국 스토리 요약해줘	getPlot
안시성 시놉시스 요약해줘	getPlot
해빙 줄거리 얘기해줘	getPlot
셔터 간략한 내용 알아?	getPlot
 줄거리 정리해줘	getPlot
셔터 시놉시스알려줘	getPlot
안시성 스토리 알아?	getPlot
인피니티워 간략한 내용 얘기해줘	getPlot
인터스텔라 스토리 정리해줘	getPlot
해빙 간략한 내용 알아?	getPlot
라라랜드 이야기 요약해줘	getPlot
 시놉시스 요약해줘	getPlot
안시성 줄거리 알아?	getPlot
해빙 간략한 내용 알려줘	getPlot
겨울왕국 스토리 얘기해줘	getPlot
라라랜드 시놉시스 정리해줘	getPlot
인터스텔라 줄거리 알려줘	getPlot
셔터 스토리 요약해줘	getPlot
인피니티워 간략한 내용 얘기해줘	getPlot
 이야기 정리해줘	getPlot
인터스텔라 줄거리 알아?	getPlot
셔터 스토리 말해줘	getPlot
안시성 시놉시스 얘기해줘	getPlot
해빙 간략한 내용 정리해줘	getPlot
인피니티워 시놉시스 요약해줘	getPlot
라라랜드 스토리 얘기해줘	getPlot
 시놉시스 좀	getPlot
셔터 스토리 알아?	getPlot
안시성 줄거리 요약해줘	getPlot
겨울왕국 간단히 내용 정리해줘	getPlot
인터스텔라 줄거리 알려줘	getPlot
인피니티워 스토리알려줘	getPlot
라라랜드 간략한 내용 정리 좀	getPlot
해빙 시놉시스 알아?	getPlot
셔터 스토리 요약 좀	getPlot
겨울왕국 간단히 내용 얘기해줘	getPlot
라라랜드 간략한 내용 알려줘	getPlot
인피니티워 줄거리 정리해줘	getPlot
 시놉시스 요약해줘	getPlot
해빙 스토리 얘기해줘	getPlot
안시성 줄거리 얘기해줘	getPlot
라라랜드 시놉시스알려줘	getPlot
안시성 줄거리 알아?	getPlot
 간략한 내용 요약해줘	getPlot
해빙 스토리 추려서 얘기해줘	getPlot
겨울왕국 간략한 내용 정리해줘	getPlot
인피니티워 시놉시스 알아?	getPlot
인터스텔라 스토리 얘기해줘	getPlot
셔터 줄거리 알려줘	getPlot
라라랜드 스토리 요약해줘	getPlot
안시성 시놉시스 정리해줄래	getPlot
 간략한 내용 얘기해줘	getPlot
셔터 줄거리 간단히 얘기해줄래	getPlot
인피니티워 스토리 정리해줘	getPlot
해빙 간략한 내용 추려서 요약해줘	getPlot
인터스텔라 시놉시스 요약해줘	getPlot
안시성 국내 개봉일 찾아	getOpenDate
라라랜드 한국 개봉일 얘기해줘	getOpenDate
겨울 왕국 VOD  출시일 검색해	search
해빙 극장  개봉일 알아?	getOpenDate
인터스텔라 DVD  출시일 알려줘	getOpenDate
인피니티 워 개봉한 날 알고 싶어	getOpenDate
어벤저스 3 개봉일 알려줘	getOpenDate
셔터 DVD  출시일 알아?	getOpenDate
겨울 왕국 개봉한 날 알고 싶어	getOpenDate
셔터 국내 개봉일 찾아	getOpenDate
어벤저스 3 VOD  출시일 검색해	search
안시성 개봉일 알려줘	getOpenDate
인터스텔라 한국 개봉일 알려줘	getOpenDate
해빙 극장  개봉일 얘기해줘	getOpenDate
라라랜드 개봉한 날 알려줘	getOpenDate
인피니티워 VOD 출시일 알려줘	getOpenDate
라라랜드 개봉일 검색해	search
겨울왕국 DVD 출시일 찾아	getOpenDate
셔터 개봉한 날 알고싶어	getOpenDate
 극장  개봉일 알려줘	getOpenDate
안시성 국내 개봉일 얘기해줘	getOpenDate
인터스텔라 한국 개봉일 알아?	getOpenDate
해빙 개봉한 날 알려줘	getOpenDate
인피니티워 DVD 출시일 찾아	getOpenDate
셔터 VOD 출시일 검색해	search
해빙 극장  개봉일 알아?	getOpenDate
 개봉일 알려줘	getOpenDate
겨울왕국 한국 개봉일 알고싶어	getOpenDate
안시성 국내 개봉일 얘기해줘	getOpenDate
인터스텔라 개봉일 얘기해줘	getOpenDate
인터스텔라 개봉일 알려줘	getOpenDate
해빙 DVD 출시일 얘기해줘	getOpenDate
 극장  개봉일 알아?	getOpenDate
겨울왕국 한국 개봉일 알고싶어	getOpenDate
안시성 국내 개봉일 찾아	getOpenDate
인피니티워 개봉한 날 검색해	search
라라랜드 VOD 출시일 알려줘	getOpenDate
셔터 국내 개봉일 얘기해줘	getOpenDate
해빙 개봉한 날 찾아	getOpenDate
인피니티워 DVD 출시일 알아?	getOpenDate
안시성 극장  개봉일 알려줘	getOpenDate
인터스텔라 VOD 출시일 알려줘	getOpenDate
 한국 개봉일 알고싶어	getOpenDate
셔터 개봉일 검색해	search
라라랜드 DVD 출시일 알려줘	getOpenDate
 국내 개봉일 알려줘	getOpenDate
해빙 극장  개봉일 찾아	getOpenDate
인터스텔라 개봉한 날 알고싶어	getOpenDate
라라랜드 개봉일 알려줘	getOpenDate
셔터 VOD 출시일 알아?	getOpenDate
인피니티워 DVD 출시일 검색해	search
겨울왕국 한국 개봉일 얘기해줘	getOpenDate
안시성 한국 개봉일 알고싶어	getOpenDate
해빙 극장  개봉일 찾아	getOpenDate
겨울왕국 개봉한 날 알려줘	getOpenDate
인터스텔라 VOD 출시일 알아?	getOpenDate
 DVD 출시일 검색해	search
인피니티워 국내 개봉일 알려줘	getOpenDate
안시성 개봉일 얘기해줘	getOpenDate
라라랜드 DVD 출시일 검색해	search
해빙 한국 개봉일 얘기해줘	getOpenDate
인터스텔라 국내 개봉일 알아?	getOpenDate
라라랜드 VOD 출시일 알려줘	getOpenDate
셔터 개봉한 날 찾아	getOpenDate
안시성 개봉일 알려줘	getOpenDate
 극장  개봉일 알고싶어	getOpenDate
인피니티워 DVD 출시일 검색해	search
겨울왕국 극장  개봉일 알려줘	getOpenDate
 개봉일 알아?	getOpenDate
인터스텔라 VOD 출시일 찾아	getOpenDate
해빙 개봉한 날 알려줘	getOpenDate
겨울왕국 한국 개봉일 얘기해줘	getOpenDate
라라랜드 DVD 출시일 검색해	search
인피니티워 국내 개봉일 알고싶어	getOpenDate
안시성 개봉일 알려줘	getOpenDate
인피니티 워 DVD  출시일 알려줘	getOpenDate
안시성 국내 개봉일 검색해	search
라라랜드 개봉일 알려줘	getOpenDate
인터스텔라 극장  개봉일 얘기해줘	getOpenDate
셔터 VOD  출시일 찾아	getOpenDate
겨울 왕국 개봉한 날 알아?	getOpenDate
해빙 한국 개봉일 알고 싶어	getOpenDate
어벤저스 3 극장  개봉일 검색해	search
셔터 VOD  출시일 알려줘	getOpenDate
인터스텔라 개봉한 날 얘기해줘	getOpenDate
안시성 한국 개봉일 알려줘	getOpenDate
라라랜드 DVD  출시일 알아?	getOpenDate
겨울 왕국 개봉일 찾아	getOpenDate
해빙 국내 개봉일 알고 싶어	getOpenDate
인피니티 워 극장  개봉일 얘기해줘	getOpenDate
겨울 왕국 국내 개봉일 얘기해줘	getOpenDate
해빙 DVD  출시일 알고 싶어	getOpenDate
라라랜드 한국 개봉일 알아?	getOpenDate
셔터 개봉일 알려줘	getOpenDate
안시성 VOD  출시일 찾아	getOpenDate
인피니티 워 극장  개봉일 검색해	search
어벤저스 3 개봉한 날 알려줘	getOpenDate
인터스텔라 개봉일 검색해	search
어벤저스 3 한국 개봉일 찾아	getOpenDate
인터스텔라 극장  개봉일 알아?	getOpenDate
해빙 VOD  출시일 얘기해줘	getOpenDate
셔터 DVD  출시일 알려줘	getOpenDate
라라랜드 개봉한 날 알고 싶어	getOpenDate
인피니티 워 국내 개봉일 알려줘	getOpenDate
안시성 VOD  출시일 찾아	getOpenDate
인피니티워 DVD 출시일 알아?	getOpenDate
해빙 극장  개봉일 알려줘	getOpenDate
 개봉한 날 검색해	search
인터스텔라 국내 개봉일 찾아	getOpenDate
안시성 VOD 출시일 얘기해줘	getOpenDate
라라랜드 한국 개봉일 알고싶어	getOpenDate
겨울왕국 개봉일 알려줘	getOpenDate
셔터 개봉한 날 검색해	search
셔터 개봉일 찾아	getOpenDate
인터스텔라 DVD 출시일 얘기해줘	getOpenDate
안시성 한국 개봉일 알고싶어	getOpenDate
겨울왕국 극장  개봉일 알려줘	getOpenDate
해빙 국내 개봉일 알려줘	getOpenDate
인피니티워 VOD 출시일 알아?	getOpenDate
라라랜드 한국 개봉일 검색해	search
안시성 극장  개봉일 얘기해줘	getOpenDate
셔터 VOD 출시일 알려줘	getOpenDate
인피니티워 DVD 출시일 알려줘	getOpenDate
인터스텔라 국내 개봉일 검색해	search
겨울왕국 한국 개봉일 찾아	getOpenDate
라라랜드 개봉일 알아?	getOpenDate
해빙 개봉한 날 알고싶어	getOpenDate
 개봉일 알고싶어	getOpenDate
셔터 한국 개봉일 알려줘	getOpenDate
인피니티워 극장  개봉일 찾아	getOpenDate
라라랜드 DVD 출시일 알아?	getOpenDate
겨울왕국 개봉한 날 얘기해줘	getOpenDate
해빙 국내 개봉일 검색해	search
안시성 VOD 출시일 알려줘	getOpenDate
인터스텔라 개봉일 찾아	getOpenDate
셔터 극장  개봉일 알아?	getOpenDate
해빙 국내 개봉일 찾아	getOpenDate
겨울왕국 개봉한 날 검색해	search
라라랜드 DVD 출시일 알려줘	getOpenDate
인터스텔라 개봉일 알려줘	getOpenDate
인피니티워 VOD 출시일 알고싶어	getOpenDate
 한국 개봉일 얘기해줘	getOpenDate
안시성 DVD 출시일 찾아	getOpenDate
해빙 국내 개봉일 알고싶어	getOpenDate
인피니티워 극장  개봉일 얘기해줘	getOpenDate
 개봉일 검색해	search
안시성 VOD 출시일 알아?	getOpenDate
셔터 개봉한 날 알려줘	getOpenDate
인터스텔라 한국 개봉일 알려줘	getOpenDate
겨울왕국 VOD 출시일 검색해	search
안시성 국내 개봉일 찾아	getOpenDate
인터스텔라 DVD 출시일 알아?	getOpenDate
해빙 극장  개봉일 알려줘	getOpenDate
셔터 한국 개봉일 알고싶어	getOpenDate
라라랜드 개봉일 얘기해줘	getOpenDate
 VOD 출시일 알려줘	getOpenDate
겨울왕국 개봉한 날 검색해	search
인피니티워 개봉일 알려줘	getOpenDate
안시성 국내 개봉일 알아?	getOpenDate
인터스텔라 개봉한 날 검색해	search
인피니티워 VOD 출시일 얘기해줘	getOpenDate
 극장  개봉일 알고싶어	getOpenDate
해빙 DVD 출시일 알려줘	getOpenDate
셔터 한국 개봉일 찾아	getOpenDate
라라랜드 DVD 출시일 알고싶어	getOpenDate
셔터 DVD 출시일 검색해	search
인피니티워 개봉일 알아?	getOpenDate
인터스텔라 개봉한 날 얘기해줘	getOpenDate
해빙 VOD 출시일 알려줘	getOpenDate
겨울왕국 국내 개봉일 알고싶어	getOpenDate
 한국 개봉일 알려줘	getOpenDate
라라랜드 극장  개봉일 찾아	getOpenDate
안시성 개봉한 날 알아?	getOpenDate
해빙 DVD 출시일 검색해	search
인피니티워 국내 개봉일 알려줘	getOpenDate
라라랜드 한국 개봉일 알고싶어	getOpenDate
인터스텔라 VOD 출시일 알려줘	getOpenDate
안시성 개봉일 찾아	getOpenDate
 극장  개봉일 얘기해줘	getOpenDate
셔터 개봉일 알고싶어	getOpenDate
인피니티워 VOD 출시일 알고싶어	getOpenDate
 국내 개봉일 검색해	search
라라랜드 극장  개봉일 알려줘	getOpenDate
겨울왕국 개봉일 알려줘	getOpenDate
안시성 한국 개봉일 얘기해줘	getOpenDate
셔터 DVD 출시일 찾아	getOpenDate
해빙 개봉한 날 알아?	getOpenDate
인터스텔라 국내 개봉일 알고싶어	getOpenDate
해빙 한국 개봉일 알아?	getOpenDate
 DVD 출시일 알려줘	getOpenDate
셔터 개봉일 얘기해줘	getOpenDate
겨울왕국 VOD 출시일 찾아	getOpenDate
라라랜드 개봉한 날 검색해	search
인터스텔라 극장  개봉일 알려줘	getOpenDate
인피니티워 국내 개봉일 검색해	search
 VOD 출시일 알려줘	getOpenDate
라라랜드 한국 개봉일 찾아	getOpenDate
안시성 DVD 출시일 알고싶어	getOpenDate
인피니티워 개봉일 얘기해줘	getOpenDate
겨울왕국 개봉한 날 알아?	getOpenDate
셔터 국내 개봉일 알려줘	getOpenDate
해빙 극장  개봉일 검색해	search
인터스텔라 극장  개봉일 찾아	getOpenDate
라라랜드 DVD 출시일 알고싶어	getOpenDate
인터스텔라 국내 개봉일 검색해	search
안시성 한국 개봉일 알려줘	getOpenDate
셔터 개봉한 날 알아?	getOpenDate
인피니티워 VOD 출시일 얘기해줘	getOpenDate
해빙 개봉일 알려줘	getOpenDate
 개봉일 알려줘	getOpenDate
해빙 개봉일 찾아	getOpenDate
셔터 국내 개봉일 알려줘	getOpenDate
라라랜드 DVD 출시일 검색해	search
인터스텔라 한국 개봉일 알고싶어	getOpenDate
 개봉한 날 알려줘	getOpenDate
겨울왕국 극장  개봉일 알아?	getOpenDate
안시성 VOD 출시일 얘기해줘	getOpenDate
인피니티워 한국 개봉일 찾아	getOpenDate
라라랜드 VOD 출시일 알려줘	getOpenDate
겨울왕국 극장  개봉일 알려줘	getOpenDate
셔터 개봉일 검색해	search
인터스텔라 국내 개봉일 얘기해줘	getOpenDate
 개봉한 날 알아?	getOpenDate
안시성 DVD 출시일 알고싶어	getOpenDate
인피니티워 국내 개봉일 찾아	getOpenDate
셔터 VOD 출시일 검색해	search
인피니티워 한국 개봉일 알려줘	getOpenDate
안시성 개봉일 알아?	getOpenDate
겨울왕국 극장  개봉일 찾아	getOpenDate
 개봉한 날 얘기해줘	getOpenDate
해빙 DVD 출시일 알고싶어	getOpenDate
인터스텔라 국내 개봉일 알려줘	getOpenDate
라라랜드 한국 개봉일 얘기해줘	getOpenDate
겨울왕국 DVD 출시일 알려줘	getOpenDate
인터스텔라 개봉일 찾아	getOpenDate
라라랜드 국내 개봉일 알아?	getOpenDate
인피니티워 극장  개봉일 검색해	search
해빙 VOD 출시일 알려줘	getOpenDate
셔터 개봉한 날 알고싶어	getOpenDate
안시성 극장  개봉일 검색해	search
안시성 한국 개봉일 알고싶어	getOpenDate
인피니티워 개봉일 알려줘	getOpenDate
 개봉한 날 찾아	getOpenDate
인터스텔라 극장  개봉일 알려줘	getOpenDate
라라랜드 DVD 출시일 얘기해줘	getOpenDate
해빙 국내 개봉일 검색해	search
셔터 VOD 출시일 알아?	getOpenDate
겨울왕국 DVD 출시일 알고싶어	getOpenDate
안시성 개봉한 날 알려줘	getOpenDate
해빙 국내 개봉일 찾아	getOpenDate
셔터 극장  개봉일 알아?	getOpenDate
겨울왕국 개봉일 검색해	search
인터스텔라 한국 개봉일 알려줘	getOpenDate
라라랜드 VOD 출시일 얘기해줘	getOpenDate
 극장  개봉일 알려줘	getOpenDate
라라랜드 개봉한 날 얘기해줘	getOpenDate
해빙 국내 개봉일 찾아	getOpenDate
안시성 VOD 출시일 알려줘	getOpenDate
겨울왕국 개봉일 검색해	search
인터스텔라 극장  개봉일 알려줘	getOpenDate
 DVD 출시일 알아?	getOpenDate
인피니티워 한국 개봉일 알고싶어	getOpenDate
셔터 개봉한 날 검색해	search
 VOD 출시일 찾아	getOpenDate
셔터 개봉일 얘기해줘	getOpenDate
겨울왕국 DVD 출시일 알려줘	getOpenDate
라라랜드 국내 개봉일 알려줘	getOpenDate
인터스텔라 극장  개봉일 알고싶어	getOpenDate
안시성 한국 개봉일 알아?	getOpenDate
해빙 국내 개봉일 찾아	getOpenDate
인피니티 워 상영 등급 몇 세?	getGrade
인터스텔라  관람 등급  알려줘	getGrade
라라랜드  관람 등급 검색해	search
안시 성상 영 등급  알고 싶어	getGrade
어벤저스 3 관람 등급  알려줘	getGrade
셔터  상영  등급  알아?	getGrade
겨울 왕국  관람 등급  찾아	getGrade
해빙  상영  등급  뭐야?	getGrade
라라랜드  관람 등급  얘기해줘	getGrade
인피니티 워  상영  등급  뭐지?	getGrade
해빙  관람 등급  몇 세?	getGrade
안시 성상 영 등급  뭐지?	getGrade
겨울 왕국  상영  등급  알고 싶어	getGrade
인터스텔라  상영  등급  얘기해줘	getGrade
어벤저스 3 관람 등급  찾아	getGrade
인터스텔라 관람 등급 검색해	search
해빙 상영 등급 뭐지?	getGrade
 상영 등급 알려줘	getGrade
안시성 관람 등급 알고싶어	getGrade
인피니티워 관람 등급 뭐야?	getGrade
셔터 상영 등급 몇 세야??	getGrade
라라랜드 관람 등급 찾아	getGrade
겨울왕국 상영 등급 얘기해줘	getGrade
안시성 상영 등급 알아?	getGrade
라라랜드 관람 등급 알려줘	getGrade
 관람 등급 몇 세야??	getGrade
인터스텔라 관람 등급 알려줘	getGrade
겨울왕국 상영 등급 뭐야?	getGrade
셔터 상영 등급 검색해	search
인피니티워 관람 등급 얘기해줘	getGrade
해빙 관람 등급 찾아	getGrade
인터스텔라 상영 등급 검색해	search
겨울왕국 관람 등급 뭐지?	getGrade
안시성 상영 등급 알고싶어	getGrade
라라랜드 상영 등급 몇 세야??	getGrade
셔터 관람 등급 알려줘	getGrade
인피니티워 관람 등급 뭐야?	getGrade
 상영 등급 알아?	getGrade
라라랜드 관람 등급 얘기해줘	getGrade
겨울왕국 관람 등급 알려줘	getGrade
 관람 등급 검색해	search
안시성 상영 등급 알아?	getGrade
셔터 상영 등급 알려줘	getGrade
인피니티워 상영 등급 알고싶어	getGrade
해빙 상영 등급 뭐지?	getGrade
인터스텔라 상영 등급 알아?	getGrade
해빙 관람 등급 알려줘	getGrade
안시성 관람 등급 뭐지?	getGrade
 상영 등급 알려줘	getGrade
겨울왕국 상영 등급 몇 세야??	getGrade
셔터 상영 등급 검색해	search
라라랜드 관람 등급 찾아	getGrade
인피니티워 관람 등급 뭐야?	getGrade
라라랜드 관람 등급 알고싶어	getGrade
겨울왕국 관람 등급 얘기해줘	getGrade
인터스텔라 상영 등급 알고싶어	getGrade
해빙 관람 등급 뭐야?	getGrade
셔터 상영 등급 알아?	getGrade
 관람 등급 알려줘	getGrade
인피니티워 상영 등급 몇 세야??	getGrade
인피니티워 관람 등급 알고싶어	getGrade
셔터 상영 등급 뭐야?	getGrade
 관람 등급 검색해	search
안시성 상영 등급 뭐지?	getGrade
인터스텔라 관람 등급 알려줘	getGrade
라라랜드 상영 등급 알려줘	getGrade
겨울왕국 상영 등급 얘기해줘	getGrade
해빙 관람 등급 몇 세야??	getGrade
 관람 등급 알아?	getGrade
해빙 상영 등급 찾아	getGrade
셔터 상영 등급 뭐지?	getGrade
겨울왕국 상영 등급 검색해	search
안시성 관람 등급 찾아	getGrade
인피니티워 상영 등급 알고싶어	getGrade
인터스텔라 관람 등급 얘기해줘	getGrade
안시성  관람 등급  뭐지?	getGrade
인터스텔라  상영  등급  얘기해줘	getGrade
인피니티 워  관람 등급  알려줘	getGrade
셔터  상영  등급  알려줘	getGrade
어벤저스 3 관람 등급  찾아	getGrade
겨울 왕국  상영  등급  뭐야?	getGrade
라라랜드  상영  등급 검색해	search
해빙  관람 등급  알고 싶어	getGrade
안시성  관람 등급  알아?	getGrade
어벤저스 3 상영  등급  몇 세?	getGrade
인터스텔라  관람 등급  뭐지?	getGrade
해빙  관람 등급  알려줘	getGrade
겨울 왕국  관람 등급  뭐야?	getGrade
셔터  상영  등급  알고 싶어	getGrade
라라랜드  상영  등급  몇 세?	getGrade
안시성 관람 등급 알려줘	getGrade
셔터 상영 등급 얘기해줘	getGrade
 상영 등급 찾아	getGrade
인피니티워 관람 등급 뭐야?	getGrade
해빙 상영 등급 알아?	getGrade
라라랜드 상영 등급 몇 세야??	getGrade
겨울왕국 관람 등급 알려줘	getGrade
인터스텔라 관람 등급 알고싶어	getGrade
 관람 등급 뭐지?	getGrade
겨울왕국 상영 등급 검색해	search
셔터 관람 등급 알아?	getGrade
인터스텔라 관람 등급 검색해	search
라라랜드 상영 등급 알려줘	getGrade
인피니티워 상영 등급 뭐지?	getGrade
해빙 관람 등급 몇 세야??	getGrade
인피니티워 상영 등급 알려줘	getGrade
겨울왕국 관람 등급 얘기해줘	getGrade
인터스텔라 관람 등급 검색해	search
안시성 상영 등급 뭐야?	getGrade
해빙 관람 등급 몇 세야??	getGrade
라라랜드 상영 등급 찾아	getGrade
 관람 등급 알고싶어	getGrade
셔터 상영 등급 알아?	getGrade
겨울왕국 상영 등급 알려줘	getGrade
안시성 관람 등급 뭐지?	getGrade
라라랜드 상영 등급 알려줘	getGrade
 상영 등급 검색해	search
해빙 관람 등급 알려줘	getGrade
인터스텔라 관람 등급 알고싶어	getGrade
셔터 관람 등급 몇 세야??	getGrade
안시성 관람 등급 알아?	getGrade
인터스텔라 상영 등급 알고싶어	getGrade
인피니티워 관람 등급 몇 세야??	getGrade
겨울왕국 상영 등급 검색해	search
셔터 상영 등급 뭐야?	getGrade
라라랜드 상영 등급 찾아	getGrade
 관람 등급 얘기해줘	getGrade
해빙 관람 등급 뭐지?	getGrade
안시성 관람 등급 알려줘	getGrade
해빙 상영 등급 알려줘	getGrade
라라랜드 상영 등급 몇 세야??	getGrade
인피니티워 관람 등급 검색해	search
겨울왕국 관람 등급 알려줘	getGrade
셔터 관람 등급 얘기해줘	getGrade
 상영 등급 뭐지?	getGrade
셔터 관람 등급 찾아	getGrade
겨울왕국 상영 등급 검색해	search
 관람 등급 뭐지?	getGrade
라라랜드 상영 등급 뭐야?	getGrade
인피니티워 관람 등급 얘기해줘	getGrade
안시성 상영 등급 알아?	getGrade
해빙 상영 등급 알려줘	getGrade
인터스텔라 관람 등급 몇 세야??	getGrade
 관람 등급 알고싶어	getGrade
인피니티워 상영 등급 알려줘	getGrade
해빙 관람 등급 몇 세야??	getGrade
안시성 상영 등급 찾아	getGrade
인터스텔라 상영 등급 알려줘	getGrade
겨울왕국 상영 등급 얘기해줘	getGrade
셔터 관람 등급 알려줘	getGrade
겨울왕국 관람 등급 뭐야?	getGrade
해빙 상영 등급 뭐지?	getGrade
 상영 등급 얘기해줘	getGrade
인터스텔라 관람 등급 검색해	search
셔터 관람 등급 알려줘	getGrade
라라랜드 상영 등급 알려줘	getGrade
인피니티워 상영 등급 몇 세야??	getGrade
안시성 관람 등급 찾아	getGrade
인피니티워 관람 등급 알고싶어	getGrade
라라랜드 관람 등급 알아?	getGrade
셔터 관람 등급 알려줘	getGrade
겨울왕국 상영 등급 얘기해줘	getGrade
안시성 상영 등급 뭐야?	getGrade
 상영 등급 알고싶어	getGrade
해빙 관람 등급 검색해	search
라라랜드 관람 등급 몇 세야??	getGrade
셔터 상영 등급 알려줘	getGrade
인피니티워 상영 등급 알아?	getGrade
인터스텔라 관람 등급 알고싶어	getGrade
겨울왕국 관람 등급 알려줘	getGrade
 관람 등급 찾아	getGrade
해빙 상영 등급 검색해	search
안시성 상영 등급 뭐야?	getGrade
안시성 관람 등급 뭐지?	getGrade
인피니티워 상영 등급 얘기해줘	getGrade
라라랜드 상영 등급 검색해	search
인터스텔라 관람 등급 얘기해줘	getGrade
해빙 관람 등급 찾아	getGrade
 상영 등급 알려줘	getGrade
셔터 상영 등급 뭐지?	getGrade
